nascent.a.01	emergent,emerging,nascent	dying,last,moribund
abridged.a.01	abridged,cut,half-length,potted,shortened	full-length,unabridged,uncut
absolute.a.01	absolute,direct,implicit,infinite,living,unquestioning	comparative,relational,relative
abstemious.a.01	abstemious,abstinent,ascetic,ascetical,austere,spartan	gluttonous,greedy,piggish,piggy,porcine,rapacious,ravening,ravenous,swinish,voracious,wolfish
abstract.a.01	abstract,conceptual,ideal,ideational,ideological,notional	concrete,objective,real,tangible
abundant.a.01	abounding,abundant,ample,copious,easy,exuberant,galore,long,lush,luxuriant,overabundant,plentiful,profuse,rampant,rank,rich,rife,riotous,teeming,thick,torrential,verdant,voluminous	rare,scarce,tight
accessible.a.01	accessible,approachable,handy,reachable	inaccessible,outback,pathless,remote,roadless,trackless,unapproachable,unreachable,unreached,untracked,untrodden
accurate.a.01	accurate,close,dead-on,faithful,hi-fi,high-fidelity,right,straight,surgical,true	away,faulty,inaccurate,incorrect,outside,unfaithful,wide,wrong
alkaline.a.01	alkalic,alkaline,basic	acid,acidic,amphoteric
acknowledged.a.01	accepted,acknowledged,given,granted,putative,recognised,recognized,self-confessed	secret,unacknowledged,unappreciated,unrecognised,unrecognized,unsung
active.a.05	about,acrobatic,active,agile,astir,athletic,gymnastic,hot,hyperactive,nimble,overactive,quick,sporty,spry	abeyant,deskbound,dormant,hypoactive,inactive,inert,sedentary,sluggish,soggy,torpid,underactive
active.a.07	active,brisk,bustling,busy,going,open,springy	dark,dead,dull,idle,inactive,slow,sluggish,strikebound,unused
active.a.03	active,activist,hands-on,proactive	hands-off,inactive,passive,supine,unresisting
actual.a.01	actual,effective,existent	latent,possible,potential
additive.a.02	accumulative,additional,additive,complementary,completing,cumulative,extra,incremental,intercalary,summative,supplemental,supplementary	ablative,reductive,subtractive
adequate.a.01	adequate,capable,competent,equal	deficient,inadequate,incapable,incompetent,lacking,short-handed,undermanned,understaffed,unequal,wanting
adorned.a.01	adorned,beady,bespectacled,brocaded,cloisonne,crested,crocketed,decorated,embossed,feathered,feathery,frilled,frilly,fringed,inflamed,inlaid,jeweled,jewelled,monocled,mounted,paneled,plumed,raised,ruffled,sequined,spangled,spangly,spectacled,studded,tasseled,tessellated,tufted	bare,plain,spare,unadorned,undecorated,unembellished,unornamented
adroit.a.01	adroit,clean,clever,co-ordinated,coordinated,cunning,deft,dexterous,dextrous,handy,ingenious,neat,quick-witted	bumbling,bungling,handless,heavy-handed,inept,left-handed,maladroit,tactless,uncoordinated
advantageous.a.01	advantageous,beneficial,discriminatory,good,plus,positive,preferential	disadvantageous,minus,negative
affected.a.01	affected,impressed,smitten,stricken,struck,subject,taken	immune,superior,unaffected,unimpressed,uninfluenced,unswayed,untouched
affected.a.02	affected,agonistic,artificial,constrained,contrived,forced,hokey,mannered,plummy,stilted,strained,unnatural	lifelike,natural,unaffected,unmannered,unselfconscious
afraid.a.01	afraid,aghast,agoraphobic,alarmed,appalled,apprehensive,claustrophobic,dismayed,fearful,frightened,hangdog,horrified,hunted,hydrophobic,numb,panic-stricken,panicked,panicky,scared,shocked,terrified,unnerved,white-lipped,xenophobic	fearless,unafraid,unblinking,unflinching,unintimidated
aggressive.a.01	aggressive,bellicose,combative,competitive,hard-hitting,high-pressure,hostile,in-your-face,militant,obstreperous,predatory,pugnacious,rapacious,raptorial,ravening,rough,scrappy,truculent	low-pressure,nonaggressive,unaggressive
alienable.a.01	alienable,assignable,negotiable,transferable,transferrable	absolute,inalienable,inviolable,non-negotiable,unalienable
alive.a.01	alive,live,viable,vital	asleep,assassinated,bloodless,breathless,cold,dead,deathlike,deathly,deceased,defunct,departed,doomed,executed,fallen,gone,inanimate,late,lifeless,murdered,nonviable,pulseless,slain,stillborn
ample.a.01	ample,full,generous,good,wide	bare,hand-to-mouth,hardscrabble,meager,meagerly,meagre,measly,miserable,paltry,scanty,spare,stingy
analytic.a.03	analytic,isolating,uninflected	agglutinative,polysynthetic,synthetic
antecedent.a.01	antecedent,anterior,anticipatory,pre-existent,pre-existing,preexisting,prevenient,prior	accompanying,attendant,concomitant,consequent,incidental,later,posterior,resultant,sequent,subsequent,ulterior
aquatic.a.02	aquatic,marine,semiaquatic,subaquatic,subaqueous,submerged,submersed,underwater	amphibious,onshore,overland,semiaquatic,terrestrial
terrestrial.a.03	onshore,overland,terrestrial	amphibious,aquatic,marine,semiaquatic,subaquatic,subaqueous,submerged,submersed,underwater
preceding.a.01	above,above-mentioned,above-named,foregoing,introductory,old,precedent,preceding,prefatory,premedical,preparative,preparatory,previous	back-to-back,consecutive,ensuing,following,next,postmortem,succeeding
anterior.a.01	anterior,frontal,prefrontal	back,caudal,hind,hinder,posterior
appropriate.a.01	appropriate,befitting,pat,proper,right	improper,inappropriate,unbefitting,wrong
armed.a.01	armed,equipped,militarised,militarized	barehanded,clean,defenceless,defenseless,unarmed,weaponless
armed.a.03	armed,barbed,bristled,bristly,burry,clawed,prickly,spiny,thorny	spineless,thornless,unarmed
armored.a.02	armored,armoured,scaled,scaly	scaleless,unarmored,unarmoured
articulate.a.01	articulate,eloquent,facile,fluent,silver,well-spoken	aphasic,dumb,inarticulate,incoherent,mute,silent,speechless,unarticulated,unspoken,voiceless,wordless
ashamed.a.01	ashamed,discredited,disgraced,dishonored,embarrassed,guilty,hangdog,humiliated,mortified,shamed,shamefaced,sheepish	audacious,barefaced,bodacious,brassy,brazen,insolent,shameless,unabashed,unashamed,unembarrassed
assertive.a.01	assertive,cocky,emphatic,forceful	reticent,retiring,self-effacing,unassertive
attached.a.03	attached,betrothed,committed,intended,involved	unattached,uncommitted,unengaged,unpledged
attentive.a.01	absorbed,attentive,captive,engrossed,intent,observant,solicitous,wrapped	absent,abstracted,distracted,dreamy,drowsy,forgetful,inattentive,moony,oblivious,yawning
attractive.a.01	attractive,bewitching,captivating,charismatic,cunning,cute,dinky,enchanting,engaging,enthralling,entrancing,fascinating,fetching,glossy,hypnotic,irresistible,magnetic,mesmeric,mesmerizing,personable,photogenic,piquant,showy,spellbinding,taking,winning,winsome	homely,plain,unattractive,unprepossessing
appealing.a.01	appealing,attention-getting,attractive,catchy	off-putting,unappealing,unattractive
audible.a.01	audible,clunky,sonic,sounding	breathed,inaudible,infrasonic,silent,supersonic,ultrasonic,unheard,voiceless
auspicious.a.01	auspicious,bright,fortunate,hopeful,promising,rosy	inauspicious,unfortunate,unpromising
propitious.a.01	favorable,favourable,golden,gracious,lucky,propitious,prosperous	ill,inauspicious,ominous,thunderous
authorized.a.01	accredited,approved,authorised,authorized,canonised,canonized,commissioned,empowered,glorified,licenced,licensed,sanctioned	self-appointed,unaccredited,unauthorised,unauthorized,unlicenced,unlicensed
available.a.01	accessible,addressable,available,easy,forthcoming,gettable,obtainable,open,purchasable,ready,visible	inaccessible,unavailable,unobtainable,untouchable
awake.a.01	astir,awake,awakened,insomniac,sleepless,up,wakeful,waking,watchful	asleep,dormant,dozy,drowsy,hibernating,sleepy,somnolent,torpid
aware.a.01	alert,alive,awake,aware,cognisant,cognizant,conscious,sensible	oblivious,unaware,unconscious,unmindful,unsuspecting
back.a.01	back,hindmost,rear,rearmost,rearward	advance,advanced,foremost,front,frontal,head-on
backward.a.01	backward,converse,inverse,rearward,receding,reflexive,retracted,retroflex,retrograde,returning,reverse,reversed,transposed	forward,full-face,guardant,headfirst,headlong
hairless.a.01	bald,bald-headed,balding,beardless,depilatory,glabrous,hairless,tonsured	comal,dark-coated,dark-haired,downy,furred,furry,fuzzed,fuzzy,haired,hairy,hirsute,hispid,hoary,long-haired,pilose,pubescent,rough-haired,short-haired,silver-haired,tomentose,wiry,woolly,wooly
beautiful.a.01	beauteous,beautiful,bonnie,bonny,comely,dishy,exquisite,fair,glorious,good-looking,gorgeous,handsome,lovely,picturesque,pretty,ravishing,resplendent,scenic,sightly,splendid,splendiferous,stunning	disfigured,grotesque,hideous,monstrous,repulsive,ugly,unlovely,unsightly
best.a.01	best,champion,first,foremost,high-grade,optimal,optimum,primo,prizewinning,record-breaking,second-best,superfine,top-grade,top-quality,unexcelled,unsurpassable,unsurpassed,world-class	bottom,last,last-place,lowest,worst
bidirectional.a.01	bidirectional,bifacial,duplex,two-way	one-way,simplex,unidirectional
unilateral.a.01	one-party,one-sided,unilateral	bilateral,bipartite,eight-sided,five-lobed,five-sided,four-party,four-sided,joint,many-sided,multilateral,multipartite,quadrilateral,quadripartite,six-sided,ten-sided,three-cornered,three-lobed,three-party,three-sided,three-way,triangular,trilateral,tripartite,two-lobed,two-part,two-sided,two-way
binaural.a.01	binaural,stereo,stereophonic,two-channel	monaural,mono,monophonic,single-channel
blond.a.01	blond,blonde,fair,flaxen,nordic,redheaded,sandy,towheaded	black-haired,bronzed,brown,brown-haired,browned,brunet,brunette,dark,dark-haired,dark-skinned,dusky,grizzled,nutbrown,suntanned,swart,swarthy,tanned
blemished.a.01	blemished,blotchy,marred,pimpled,pimply,pocked,pockmarked,scarred	stainless,unblemished,unmarred,unstained,unsullied,untainted,untarnished
bold.a.01	audacious,bold,brave,daredevil,dauntless,emboldened,fearless,foolhardy,hardy,heady,heroic,intrepid,nervy,overreaching,rash,reckless,vaulting	bashful,coy,fearful,intimidated,mousey,mousy,timid,timorous
bound.a.01	bound,chained,fettered,furled,pinioned,rolled,shackled,tethered,tied,trussed,wired	unbound,unchained,unfettered,unshackled,untethered,untied
tangled.a.01	afoul,enmeshed,entangled,foul,fouled,knotty,matted,snarled,snarly,tangled,thrown	disentangled,loosened,untangled
lower-class.a.01	blue-collar,low-class,lower-class,proletarian,working-class	bourgeois,conservative,lower-middle-class,materialistic,middle-class,propertied,quality,tweedy,u,upper-class,upper-middle-class,wellborn
middle-class.a.01	bourgeois,conservative,lower-middle-class,materialistic,middle-class,upper-middle-class	blue-collar,low-class,lower-class,proletarian,propertied,quality,tweedy,u,upper-class,wellborn,working-class
upper-class.a.01	propertied,quality,tweedy,u,upper-class,wellborn	blue-collar,bourgeois,conservative,low-class,lower-class,lower-middle-class,materialistic,middle-class,proletarian,upper-middle-class,working-class
brave.a.01	brave,courageous,desperate,gallant,game,gamey,gamy,gritty,heroic,lionhearted,spirited,spunky,stalwart,undaunted,valiant,valorous	chicken,cowardly,craven,dastardly,faint,fainthearted,fearful,funky,pusillanimous,timid,unmanly,yellow,yellow-bellied
light.a.06	ablaze,bioluminescent,bright,floodlit,fluorescent,illuminated,incandescent,inflamed,light,lighted,lit,livid,luminescent,phosphorescent,reddened,sunlit,white	black,crepuscular,dark,darkened,darkening,darkling,dim,dusky,gloomy,lightless,pitch-black,subdued,sulky,tenebrous,twilight,unlighted,unlit
bright.a.01	aglow,ardent,beady,beaming,blazing,blinding,bright,brilliant,coruscant,dazzling,glaring,gleaming,glinting,glistening,glittering,glittery,glossy,iridescent,lambent,lucent,luminous,lurid,lustrous,nacreous,noctilucent,opalescent,opaline,pearlescent,radiant,satiny,scintillating,shimmery,shining,shiny,silken,silky,silver,silvery,sleek,slick,sparkly,twinkling	dull,flat,lackluster,lacklustre,lusterless,mat,matt,matte,matted,soft,subdued
prejudiced.a.02	discriminatory,homophobic,jaundiced,loaded,prejudiced,racist,sexist	color-blind,impartial,unprejudiced
broad-minded.a.02	broad,broad-minded,catholic,free-thinking,latitudinarian,liberal,open-minded,tolerant,undogmatic	dogmatic,illiberal,intolerant,narrow,narrow-minded,opinionated,petty
broken.a.02	broken,dashed,dotted,fitful,halting,interrupted,off-and-on	solid,unbroken,uninterrupted
busy.a.01	busy,engaged,laboring,labouring,occupied,toiling	idle,indolent,lackadaisical,lazy,leisured,slothful,unengaged
bony.a.03	bone,boned,boney,bony	boned,boneless,deboned
capitalistic.a.01	bourgeois,capitalist,capitalistic,competitive,individualistic,laissez-faire	collective,collectivised,collectivist,collectivistic,collectivized,socialist,socialistic,state-controlled
cacophonous.a.01	cacophonous,croaky,grating,gravelly,gruff,guttural,hoarse,husky,jangling,jangly,jarring,rasping,raspy,raucous,rending,ripping,rough,scratchy,splitting,strident	euphonious,golden,silvery
calculable.a.01	calculable,computable,countable,enumerable,estimable	countless,immeasurable,incalculable,indeterminable,inestimable,infinite,innumerable,multitudinous,myriad,numberless,uncounted,unnumbered
calm.a.02	calm,placid,quiet,settled,smooth,still,tranquil,unruffled,windless	angry,billowing,billowy,blustering,blustery,boisterous,breezy,choppy,dirty,fierce,furious,gusty,puffy,raging,rough,squally,stormy,surging,tempestuous,wild,windy
careful.a.01	careful,certain,close,conscientious,detailed,elaborate,elaborated,minute,narrow,painstaking,particular,protective,scrupulous,studious,sure,thorough	careless,casual,cursory,haphazard,heedless,incautious,offhand,offhanded,passing,perfunctory,reckless,slapdash,slipshod,sloppy
carnivorous.a.02	carnivorous,flesh-eating,meat-eating,piscivorous,predaceous	fruit-eating,herbivorous,insectivorous,omnivorous,phytophagous,plant-eating,saprophytic
herbivorous.a.01	fruit-eating,herbivorous,phytophagous,plant-eating,saprophytic	carnivorous,flesh-eating,insectivorous,meat-eating,omnivorous,piscivorous,predaceous
cautious.a.01	cagey,cautious,chary,fabian,gingerly,guarded,overcautious,restrained	hotheaded,impetuous,impulsive,incautious,madcap,tearaway
cellular.a.02	cancellous,cellular,honeycombed,multicellular,pitted	acellular,cell-free,single-celled
central.a.02	bifocal,center,centered,central,centric,focal,halfway,medial,median,middle,midway,nuclear	circumferential,encircling,fringy,marginal,off-base,peripheral,skirting
afferent.a.01	afferent,centripetal,receptive,sensory	centrifugal,efferent,motor
centralizing.a.01	centralising,centralizing,centripetal,integrative,unifying	centrifugal,decentralising,decentralizing
certain.a.02	certain,confident,convinced,positive,sure	ambivalent,doubtful,dubious,groping,uncertain,unsure
confident.a.01	assured,cocksure,confident,overconfident,positive,reassured,self-assured,self-confident	diffident,shy,timid,unsure
certain.a.04	bound,certain,destined,doomed,fated,foreordained,predestined,sure	chancy,contingent,flukey,fluky,iffy,uncertain
changeable.a.02	adjustable,changeable,checkered,erratic,fickle,fluid,jittering,kaleidoscopic,mercurial,mobile,open-ended,quick-change,quicksilver,reversible,unstable,volatile	changeless,confirmed,fixed,frozen,stable,static,unalterable,unchangeable,unchanging
altered.a.01	adjusted,altered,changed,edited,emended,revised	dateless,in-situ,timeless,unaltered,unchanged,unedited,unmoved,unreduced,unrevised
changed.a.01	changed,denatured,exchanged,transformed,varied	idempotent,same,unchanged
charged.a.01	charged,electronegative,electropositive,hot,live,negative,polar,positive	dead,drained,neutral,uncharged
chaste.a.01	celibate,chaste,continent,pure,vestal,virgin,virginal,virtuous	cyprian,easy,fallen,licentious,light,loose,promiscuous,unchaste,wanton
cheerful.a.01	beaming,beamish,blithe,buoyant,cheerful,cheery,chipper,chirpy,debonair,gay,glad,jaunty,light-hearted,lighthearted,perky,smiling,sunny,twinkly	blue,cheerless,dark,depressing,dingy,disconsolate,dismal,drab,drear,dreary,gloomy,grim,melancholy,somber,sombre,sorry
chromatic.a.03	amber,amethyst,auburn,avocado,azure,beige,blackish-brown,blood-red,blue,blue-green,blue-purple,blue-violet,blueish,bluish,bronze,bronzy,brown,brownish,brownish-orange,brownish-red,brownish-yellow,buff,canary,caramel,carmine,carnation,cerise,cerulean,chartreuse,cherry,chestnut,chestnut-brown,chocolate-brown,chromatic,cinnabar,coppery,coral,creamy,cresson,crimson,cyan,dark-blue,dark-brown,dark-green,drab,dun,earthlike,fuscous,gilded,gilt,gold,golden,golden-brown,golden-yellow,gray-brown,gray-green,grayish-brown,green,greenish,greenish-brown,grey-blue,grey-brown,grey-green,greyish-brown,greyish-green,hazel,honey,jade,khaki,lavender,light-blue,lilac,magenta,maroon,mauve,mousey,mousy,ocher,ochre,olive,olive-brown,orange,orange-brown,orange-red,orangish,peachy,pink,pink-tinged,pinkish,purple,purple-blue,purple-brown,purple-red,purple-tinged,purplish,purplish-brown,red,red-brown,red-orange,red-purple,red-violet,reddish,reddish-brown,reddish-orange,rose,roseate,rosy,ruby,ruddy,russet,rust,rusty,sage,salmon,sapphire,scarlet,sky-blue,snuff,sorrel,stone,straw,tan,tangerine,taupe,tawny,teal,ultramarine,umber,vermilion,vermillion,violet,violet-blue,watercress,yellow,yellow-brown,yellow-green,yellow-orange,yellowish,yellowish-orange	achromatic,argent,ashy,blackish,blue-black,blue-gray,blue-grey,blue-white,bluish-gray,bluish-grey,bluish-white,brown-black,brown-grey,brownish-black,brownish-gray,brownish-grey,chalky,charcoal,ebon,ebony,gray,grayish,greenish-white,grey,grey-black,grey-white,greyish,greyish-white,inky,jet,jet-black,milk-white,neutral,off-white,pearly,purple-black,sable,silver,silver-grey,silver-white,silvery,silvery-white,slaty,snow-white,snowy,sooty,white-flowered,whitish,yellow-white,yellowish-white
colorful.a.01	ablaze,bright,brilliant,changeable,colorful,colourful,deep,fluorescent,iridescent,prismatic,psychedelic,rich,shot,shrill,vibrant,vivid	ashen,blanched,bleached,bloodless,colorless,colourless,drab,dulled,faded,livid,lurid,pale,pallid,pasty,sober,somber,sombre,wan,washed-out,washy,waxen,waxy,white,whitened
colorful.a.02	brave,colorful,colourful,flashy,gaudy,gay,jazzy,many-sided,noisy,picturesque,showy,sporty	colorless,colourless,neutral,pale,pallid
civilized.a.01	advanced,civil,civilised,civilized,humane	barbarian,barbaric,barbarous,preliterate,primitive,savage,uncivilised,uncivilized,wild
classical.a.01	classic,classical,neoclassic,neoclassical	modern,nonclassical,pop,popular
classified.a.01	categorised,categorized,classified,grouped,sorted	uncategorized,unclassified,unsorted
classified.a.02	classified,confidential,restricted,secret,sensitive,top-secret	declassified,unclassified,unrestricted
clean.a.01	clean,cleanly,fresh,immaculate,pristine,scrubbed,spic,spick,spotless,unspotted,unstained,unsullied,unused,washed	bedraggled,befouled,black,buggy,cobwebby,dingy,dirty,filthy,foul,fouled,greasy,grimy,grubby,grungy,lousy,mucky,muddy,nasty,oily,ratty,raunchy,scummy,smudgy,smutty,snotty,soiled,sooty,sordid,squalid,unclean,unswept,unwashed
clean.a.08	antiseptic,clean,unobjectionable	bawdy,blasphemous,blue,cruddy,dirty,filthy,foul,foul-mouthed,lewd,nasty,obscene,off-color,profane,raunchy,ribald,salacious,scabrous,scatological,smutty
clean.a.06	clean,halal,kosher	impure,nonkosher,tref,unclean,untouchable
clear.a.01	broad,clear,clear-cut,distinct,limpid,lucid,pellucid,trenchant,unmistakable,unsubtle,vivid	blurred,clouded,confusing,obscure,perplexing,puzzling,unclear,vague
clear.a.04	clear,crystalline,hyaline,limpid,liquid,lucid,pellucid,semitransparent,translucent,transparent,unclouded	cloudy,fogged,foggy,frosted,glaucous,milky,muddy,murky,opaque,solid,turbid,whitish
clearheaded.a.01	clear,clearheaded,unclouded	addled,befogged,befuddled,clouded,confused,dazed,dazzled,muddled,muzzy,silly,spaced-out,stunned,stupefied,stupid,trancelike,woolly,wooly
smart.a.01	astute,cagey,canny,clever,sharp,shrewd,smart,streetwise	boneheaded,dense,dim,doltish,dopey,dull,dumb,foolish,goosey,jerky,lumpen,lumpish,obtuse,senseless,slow,stupid,thick,thickheaded,unthinking,weak,witless
far.a.01	cold,distant,far,far-off,faraway,farther,farthest,further,furthermost,furthest,out-of-the-way,outlying,remote,removed,utmost,uttermost	adjacent,close,hot,near,nearby,nigh,warm
distant.a.01	deep,distant,extreme,far-flung,long-distance,out-of-town,yon,yonder	adjacent,ambient,appressed,approximate,close,contiguous,encompassing,enveloping,hand-to-hand,immediate,imminent,impending,juxtaposed,nestled,next,proximate,snuggled,surrounding,walking
distant.a.02	distant,faraway,remote,removed,ulterior	approximate,boon,chummy,close,close-knit,confidential,cozy,dear,familiar,good,intimate,near,thick
clothed.a.01	arrayed,attired,breeched,caparisoned,clad,clothed,coated,costumed,cowled,dressed,garbed,gowned,overdressed,robed,suited,trousered,tuxedoed,underdressed,uniformed	bare,bare-breasted,bared,bareheaded,bottomless,braless,exposed,naked,nude,peeled,raw,seminude,stripped,topless,unclad,unclothed,uncovered,undressed
clear.a.11	clear,cloudless,fair,serene,unclouded	clouded,cloudlike,cloudy,dull,fogbound,foggy,hazy,heavy,leaden,lowering,misty,nebular,overcast,smoggy,sullen,sunless,threatening,vaporous
coastal.a.02	coastal,coastwise,inshore,maritime,seaward	inland,interior,landlocked,midland,upcountry
coherent.a.01	coherent,consistent,logical,ordered,seamless	confused,disconnected,disjointed,disordered,fuzzy,garbled,illogical,incoherent,scattered,unconnected
collective.a.02	agglomerate,agglomerated,aggregate,aggregated,clustered,collective,collectivised,collectivized,knockdown,mass	diffusing,diffusive,dispersive,distributive,immanent,permeating,pervasive,separative
publicized.a.01	advertised,heralded,promulgated,publicised,publicized,published	quelled,quenched,squelched,suppressed,unreleased
combustible.a.01	burnable,combustible,flammable,ignitable,incendiary,inflammable	fire-resistant,fire-retardant,fireproof,flameproof,nonflammable
comfortable.a.01	comfortable,comfy,cosy,cozy,easy,homelike,homely,homey,snug,soothing	bad,irritating,miserable,painful,tough,uncomfortable,uneasy,warm,wretched
commensurate.a.01	coextensive,commensurable,commensurate,conterminous,coterminous,proportionate	disproportionate,incommensurable,incommensurate
commercial.a.01	commercial,commercialised,commercialized,mercantile,mercenary,moneymaking,technical	non-profit-making,noncommercial,nonprofit,uncommercial
common.a.02	average,common,democratic,demotic,frequent,general,grassroots,ordinary,popular,standard	especial,exceptional,particular,rare,red-carpet,special,uncommon,unusual
usual.a.01	accustomed,chronic,customary,habitual,inveterate,regular,usual	different,extraordinary,odd,out-of-the-way,peculiar,unaccustomed,unique,unusual
common.a.01	common,communal,public	idiosyncratic,individual,individualist,individualistic,man-to-man,one-on-one,respective,several,single,singular,various
communicative.a.02	anecdotal,chatty,communicable,communicational,communicative,expansive,expressive,gesticulating,gestural,gossipy,heraldic,leaky,narrative,newsy,nonverbal,openhearted,outspoken,sign,signed,talkative,tattling,verbal,vocal	blank,close,closemouthed,deadpan,expressionless,impassive,incommunicado,inexpressive,mum,secretive,silent,tightlipped,uncommunicative,unpronounceable,unutterable,vacuous
compact.a.01	clayey,close-packed,compact,consolidated,heavy,impacted,packed,serried,tight,wedged	light,loose,shifting,silty,unconsolidated
compatible.a.01	compatible,congenial,congruous,harmonious	antagonistic,clashing,contradictory,incompatible,uncongenial
competent.a.01	able,capable,competent,effective,efficient,workmanlike	feckless,incompetent,ineffective,inefficient,inept
competitive.a.01	agonistic,combative,competitive,matched,rivalrous	accommodative,cooperative,monopolistic,noncompetitive,uncompetitive
whole.a.01	entire,full,full-length,full-page,intact,integral,total,undivided,whole	aliquot,divisional,fractional,fragmental,fragmentary,half,halfway
committed.a.01	committed,pledged,sworn	floating,uncommitted,undecided
complete.a.01	absolute,accomplished,all,all-or-nothing,all-out,allover,clean,complete,completed,dead,downright,exhaustive,full,full-blown,full-dress,full-scale,good,hearty,out-and-out,rank,realised,realized,self-contained,sheer,sound,stand-alone,thorough,thoroughgoing,total,utter	broken,half,incomplete,neither,partial,rudimentary,sketchy,uncompleted
composed.a.01	calm,collected,composed,cool,coolheaded,imperturbable,nerveless,poised,self-contained,self-possessed,serene,tranquil,unflappable,unflustered,unperturbed,unruffled	abashed,blushing,bothered,chagrined,daunted,discombobulated,disconcerted,embarrassed,fazed,flustered,perturbed,rattled,red-faced,unstrung
comprehensible.a.01	accessible,approachable,comprehensible,fathomable,graspable,intelligible,perceivable,understandable	dark,enigmatic,impenetrable,incomprehensible,indecipherable,lost,missed,obscure,opaque,puzzling,unfathomable,unintelligible
concave.a.01	acetabular,boat-shaped,bowl-shaped,concave,dished,recessed,saucer-shaped,umbilicate,urn-shaped	bell-shaped,biconvex,bulging,convex,gibbous,hogged,lenticular
concentrated.a.01	bunchy,concentrated,exclusive,single,thick,thickset,undivided	apportioned,broken,diffuse,diffused,dispensed,dispersed,distributed,divided,encyclical,fanned,far-flung,low-density,rationed,scattered,separated,shared,spaced,sparse,splashed,spread,spread-out,straggly,thin,unfocused,widespread
concerned.a.01	afraid,concerned,haunted,obsessed,preoccupied,solicitous	blase,blithe,casual,detached,indifferent,insouciant,nonchalant,unconcerned,uninvolved
concise.a.01	aphoristic,brief,compact,compendious,concise,crisp,cryptic,curt,elliptic,elliptical,epigrammatic,laconic,pithy,sententious,succinct,summary,telegraphic,terse	diffuse,long-winded,prolix,redundant,tautological,tedious,verbal,verbose,windy,wordy
conclusive.a.01	conclusive,definitive,determinate	equivocal,head-to-head,inconclusive,indeterminate,nisi
accordant.a.01	according,agreeable,concordant,concurring,consensual,unanimous	discordant,discrepant,dissonant,divisive,factious
conditional.a.02	conditional,contingent,counterfactual,dependant,dependent,probationary,provisional,provisory,qualified,tentative	blunt,crude,stark,unconditional,unconditioned,vested
congruous.a.01	congruent,congruous,harmonious	discrepant,inappropriate,incompatible,incongruous,inconsistent,inharmonious,ironic,ironical,unfitting
connected.a.02	adjacent,adjunctive,connected,conterminous,contiguous,coupled,engaged,joined,linked,neighboring,well-connected	apart,detached,exploded,isolated,obscure,separate,separated,unattached,unconnected,uncoupled
conscious.a.02	conscious,self-aware,self-conscious,semiconscious,sentient	cold,comatose,innocent,insensible,out,senseless,stunned,subconscious,unconscious
consecrated.a.01	consecrate,consecrated,dedicated,ordained,votive	deconsecrated,desecrated,profaned,violated
conservative.a.01	conservative,fusty,hidebound,traditionalist,ultraconservative	liberal,neoliberal,progressive,reform-minded,reformist,socialised,socialized
consistent.a.01	agreeable,concordant,conformable,consistent,consonant,pursuant,reconciled,self-consistent,unchanging	conflicting,contradictory,discrepant,incompatible,inconsistent,scratchy,self-contradictory,spotty,uneven,unreconciled
conspicuous.a.01	attention-getting,big,bold,conspicuous,crying,egregious,eye-catching,featured,flagrant,glaring,gross,large,marked,outstanding,prominent,rank,salient,spectacular,striking	inconspicuous,invisible,obscure,unnoticeable
constant.a.02	constant,staunch,steadfast,unfailing,unflagging,unswerving	false,fickle,inconstant,untrue,volatile
constructive.a.01	constructive,creative,formative,inferential,plastic,reconstructive,rehabilitative,shaping,structural	annihilating,blasting,cataclysmic,caustic,corrosive,crushing,damaging,destructive,devastating,erosive,iconoclastic,mordant,negative,ravaging,ruinous,vitriolic,wasteful,withering
contented.a.01	complacent,content,contented,satisfied,self-satisfied,smug	disaffected,discontent,discontented,disgruntled,dissatisfied,malcontent,rebellious,restless,unsatisfied
contestable.a.01	contestable,debatable,disputable	bulletproof,demonstrable,demonstrated,inarguable,incontestable,incontrovertible,unanswerable,unarguable,unassailable,unshakable,watertight
continual.a.01	continual,insistent,perennial,persistent,recurrent,recurring,relentless,repeated,repetitive,revenant,running,unrelenting	fitful,intermittent,irregular,isolated,occasional,periodic,spasmodic,sporadic,stray,unpredictable
continuous.a.01	around-the-clock,ceaseless,consecutive,constant,continual,continuous,dogging,endless,incessant,never-ending,nonstop,perpetual,persisting,round-the-clock,straight,sustained,unceasing,uninterrupted,unremitting	discontinuous,disjunct,disrupted
controlled.a.01	contained,controlled,disciplined,dominated,harnessed,obsessed,possessed,regimented	anarchic,anarchical,errant,irrepressible,lawless,loose,masterless,rampant,runaway,torrential,uncontrollable,uncontrolled,undisciplined,ungoverned,wild
controversial.a.01	arguable,contentious,controversial,debatable,disputable,disputed,moot,polemic,polemical	noncontroversial,unchallengeable,unchallenged,uncontroversial,undisputed,unquestioned
conventional.a.01	conventional,customary,formulaic,received,stodgy,stuffy	alternative,bizarre,bohemian,devil-may-care,eccentric,flakey,flaky,freakish,freaky,funky,gonzo,irregular,kinky,maverick,off-the-wall,offbeat,outlandish,outre,quirky,raffish,rakish,spaced-out,spacey,spacy,unconventional,unorthodox
conventional.a.04	button-down,conservative,conventional,square,stereotyped,stereotypic,stereotypical,straight,unimaginative	alternative,bizarre,devil-may-care,eccentric,flakey,flaky,freakish,freaky,funky,gonzo,kinky,off-the-wall,offbeat,outlandish,outre,quirky,raffish,rakish,spaced-out,spacey,spacy,unconventional
convergent.a.01	confluent,convergent,focused,focussed,merging	branching,divergent,diverging,radiating
convincing.a.01	convincing,credible,disillusioning	flimsy,unconvincing,unpersuasive
cooked.a.01	baked,barbecued,boiled,braised,broiled,burned,burnt,cooked,deep-fried,done,fried,grilled,hard-boiled,lyonnaise,medium,overdone,parched,poached,roast,roasted,saute,sauteed,seared,steamed,stewed,toasted,well-done	half-baked,rare,raw,uncooked,underdone,untoasted
corrupt.a.01	corrupt,corrupted,corruptible,debased,depraved,dirty,dishonest,perverse,perverted,purchasable,putrid,reprobate,sold-out,sordid,venal,vitiated	antiseptic,incorrupt,incorruptible,uncorrupted,unspoiled
substantial.a.03	material,real,substantial	aerial,airy,ethereal,insubstantial,shadowy,stringy,unreal,unsubstantial,wraithlike
corporeal.a.01	bodied,bodily,corporal,corporate,corporeal,embodied,incarnate,material,reincarnate	bodiless,disembodied,immaterial,incorporeal,spiritual
correct.a.01	accurate,correct,exact,precise,right,straight	erroneous,fallacious,false,incorrect,mistaken,wrong
corrigible.a.01	amendable,correctable,redeemable	incorrigible,uncontrollable,unmanageable,unregenerate
cosmopolitan.a.02	cosmopolitan,traveled,travelled	hick,insular,one-horse,parochial,pokey,poky,provincial,rustic,stay-at-home,unsophisticated
courteous.a.02	chivalrous,courteous,gallant,knightly	abrupt,brusque,caddish,curt,discourteous,short,unceremonious
polite.a.01	courteous,gracious,mannerly,nice,polite,well-mannered	bratty,discourteous,ill-mannered,impolite,rude,ungracious,unmannered,unparliamentary
creative.a.01	creative,fanciful,fictive,imaginative,inventive,notional,yeasty	sterile,uncreative,unimaginative,uninspired
credible.a.01	believable,credible,likely,presumptive	astounding,dumbfounding,fabulous,improbable,incredible,marvellous,marvelous,tall,unbelievable,undreamed,unimagined
credulous.a.01	credible,credulous,unquestioning	disbelieving,incredulous,sceptical,skeptical,unbelieving
cubic.a.01	blocky,box-shaped,boxlike,boxy,cube-shaped,cubic,cubical,cuboid,cuboidal,isometric,solid,three-dimensional	collinear,coplanar,flat,flattened,lineal,linear,one-dimensional,planar,rectilinear,tabular,two-dimensional
linear.a.02	collinear,lineal,linear,one-dimensional,rectilinear	blocky,box-shaped,boxlike,boxy,coplanar,cube-shaped,cubic,cubical,cuboid,cuboidal,flat,flattened,isometric,planar,solid,tabular,three-dimensional,two-dimensional
planar.a.01	coplanar,flat,flattened,planar,tabular,two-dimensional	blocky,box-shaped,boxlike,boxy,collinear,cube-shaped,cubic,cubical,cuboid,cuboidal,isometric,lineal,linear,one-dimensional,rectilinear,solid,three-dimensional
current.a.01	actual,afoot,circulating,contemporary,current,incumbent,latest,live,on-going,on-line,ongoing,online,present-day,topical,underway,up-to-date,up-to-the-minute	back,dead,disused,obsolescent,obsolete,out-of-date,outdated,superannuated
cursed.a.01	accursed,blame,blamed,blasted,blessed,cursed,damn,damnable,damned,darned,execrable,goddam,goddamn,goddamned,infernal	blessed,blest,fortunate,golden
custom-made.a.01	bespoke,custom,custom-built,custom-made,made-to-order,tailor-made,tailored	made,off-the-shelf,prefab,ready-made,ready-to-eat,ready-to-wear
homemade.a.01	do-it-yourself,homemade,homespun	factory-made,manufactured,mass-produced,ready-made,store-bought
decisive.a.03	decisive,resolute,unhesitating	hesitant,hesitating,indecisive,suspensive,undecided
deep.a.03	abysmal,abyssal,bottomless,deep,deep-water,profound,unfathomable,walk-in	fordable,knee-deep,neritic,shallow
deep.a.01	deep,heavy,profound,sound	light,shallow,wakeful
defeated.a.01	defeated,licked,subjugated	triumphant,unbeaten,unbowed,unconquered,undefeated,unvanquished,victorious
defiant.a.01	defiant,insubordinate,noncompliant,obstreperous,recalcitrant,resistant,resistive	amenable,compliant,conformable,nonresistant
definite.a.01	certain,decided,decisive,definite,distinct	coy,indecisive,indefinite,nebulous,noncommittal,one,unfixed
dejected.a.01	blue,crestfallen,deflated,dejected,depressed,dispirited,down,downcast,downhearted,gloomy,glum,grim,lonely,lonesome,low	elated,exhilarated,exultant,exulting,gladdened,high,jubilant,prideful,rejoicing,sublime,triumphal,triumphant,uplifted
delicate.a.01	dainty,delicate,ethereal,exquisite,fragile,gossamer,pastel,tender	knockabout,rugged,sturdy,tough
demanding.a.01	demanding,exacting,exigent,needy,rigorous,stern,strict,stringent,tight	easygoing,lenient,light,undemanding
imperative.a.01	crying,desperate,exigent,imperative,insistent,instant,peremptory,pressing,shrill,strident,urgent	beseeching,imploring,importunate,mendicant,pleading,supplicant
democratic.a.01	classless,democratic,egalitarian,parliamentary,participatory,popular,representative,republican	authoritarian,autocratic,despotic,dictatorial,monarchic,monarchical,totalitarian,tyrannic,tyrannical,undemocratic
demonstrative.a.01	demonstrative,effusive,epideictic,gushing,gushy	restrained,reticent,undemonstrative,unemotional
denotative.a.01	appellative,extensional,naming,referent,referential	connotative,inferential,intensional,suggestive
reliable.a.01	certain,dependable,reliable,sure,tested,time-tested,tried,undeviating	erratic,temperamental,uncertain,undependable,unreliable,unsound
dependent.a.01	bloodsucking,dependent,helpless,interdependent,mutualist,parasitic,parasitical,reliant,symbiotic,underage	autarkic,autonomous,breakaway,case-by-case,commutative,free-living,independent,indie,individual,self-directed,self-reliant,self-sufficient,self-supporting,self-sustaining,separatist,single-handed,strong-minded,unaffiliated,unconditional
partisan.a.01	partisan,partizan,tendentious	bipartisan,independent,nonpartisan,two-party,two-way,unbiased
desirable.a.01	coveted,delectable,desirable,desired,enviable,plummy,preferable,preferred	undesirable,unenviable,unwanted
destroyed.a.01	annihilated,blighted,broken,burned,burned-out,burnt,burnt-out,demolished,despoiled,destroyed,dismantled,exterminated,extinguished,fallen,finished,gone,impoverished,kaput,obliterate,obliterated,pillaged,raped,ravaged,razed,ruined,sacked,scorched,shattered,spoilt,tattered,totaled,war-torn,wrecked	conserved,maintained,preserved,protected,retained,saved,well-kept
determinable.a.01	ascertainable,definable,determinable,discoverable	indeterminable,indeterminate,unpredictable
developed.a.01	developed,formulated,mature,matured	budding,rudimentary,undeveloped,vestigial
difficult.a.01	ambitious,arduous,awkward,baffling,catchy,challenging,delicate,difficult,elusive,embarrassing,fractious,hard,hard-fought,herculean,knotty,nasty,problematic,problematical,rocky,rough,rugged,serious,sticky,tall,thorny,ticklish,tight,touchy,tough,tricky,troublesome,trying,unenviable,vexed	casual,clean,cushy,easy,easygoing,effortless,elementary,painless,simple,simplified,smooth,soft,uncomplicated,unproblematic,user-friendly
dignified.a.01	courtly,dignified,distinguished,formal,grand,imposing,magisterial,stately	demeaning,humbling,humiliating,mortifying,pathetic,ridiculous,silly,undignified
diligent.a.02	assiduous,diligent,hardworking,industrious,tireless,untiring	delinquent,derelict,hit-and-run,inattentive,lax,neglectful,negligent,remiss,slack
diluted.a.01	cut,dilute,diluted,thinned,washy,watery,weak,weakened,white	black,concentrated,full-strength,neat,straight,undiluted
direct.a.01	direct,door-to-door,nonstop,point-blank,straightforward,through,undeviating,unswerving	askance,circuitous,devious,diversionary,indirect,meandering,rambling,roundabout,sidelong,squint,squinty,wandering,winding
direct.a.03	bluff,blunt,brutal,candid,direct,flat-footed,forthright,frank,man-to-man,no-nonsense,outspoken,plain,plainspoken,point-blank,pointed,square,straight,straightforward,unvarnished,upfront	allusive,backhanded,circuitous,devious,digressive,discursive,hearsay,indirect,oblique,periphrastic,rambling,roundabout,tortuous
immediate.a.03	direct,immediate,unmediated	indirect,mediate,mediated
discriminating.a.01	appreciative,diacritic,diacritical,discerning,discriminating,discriminative,discriminatory,eclectic,good,selective	indiscriminate,scattershot,undiscriminating
distinct.a.02	chiseled,clean-cut,clear,clear-cut,crisp,crystalline,defined,distinct,knifelike,outlined,razor-sharp,sharp,well-defined	bleary,blurred,blurry,cloudy,dim,faint,foggy,fuzzy,hazy,indistinct,muzzy,nebulous,shadowy,vague,veiled,wispy
diversified.a.01	diversified,varied,wide-ranging	general,monolithic,solid,unanimous,undistributed,whole
divisible.a.01	dissociative,divisible,partible,separable	indiscrete,indivisible,inseparable
domineering.a.01	authoritarian,autocratic,blustery,bossy,bullying,cavalier,dictatorial,dominating,domineering,heavy-handed,high-handed,magisterial,oppressive,overbearing,peremptory,roughshod,tyrannical,tyrannous	abject,bowed,bowing,cringing,dominated,groveling,grovelling,henpecked,meek,spiritless,submissive,wormlike,wormy
dominant.a.01	ascendant,ascendent,controlling,dominant,dominating,governing,overriding,paramount,possessive,predominant,predominate,preponderant,sovereign,superior,supreme	adjunct,assistant,associate,low-level,secondary,subordinate,under
intoxicated.a.01	bacchanal,bacchanalian,bacchic,beery,besotted,bibulous,blotto,boozy,carousing,cockeyed,crocked,doped,drugged,drunk,drunken,high,inebriated,intoxicated,loaded,mellow,orgiastic,pissed,pixilated,plastered,potty,slopped,sloshed,smashed,soaked,soused,stiff,stoned,tight,tipsy,wet	drug-free,dry,sober,teetotal
dull.a.09	blunt,blunted,dull,dulled	edged,incisive,keen,knifelike,penetrating,penetrative,razor-sharp,sharp,sharpened
lively.a.01	alive,bouncing,bouncy,breezy,bubbling,bubbly,burbling,effervescent,effusive,frothy,gushing,live,lively,peppy,scintillating,sparkly,spirited,warm,zippy	arid,bovine,desiccated,drab,dreary,dull,heavy,humdrum,lackluster,lacklustre,leaden,lusterless,monotonous
dynamic.a.01	can-do,changing,driving,dynamic,dynamical,energising,energizing,ever-changing,high-energy,high-octane,high-power,high-powered,high-voltage,impulsive,kinetic,projectile,propellant,propellent,propelling,propulsive,self-propelled,slashing	backward,moribund,stagnant
early.a.01	aboriginal,advance,archaean,archean,beforehand,earlier,earliest,early,premature,previous,primal,primeval,primordial,proterozoic,proto,untimely,wee	advanced,after-hours,intervening,late,mid,middle,posthumous,ripe
middle.a.04	intervening,mid,middle	aboriginal,advance,advanced,after-hours,archaean,archean,beforehand,earlier,earliest,early,late,posthumous,premature,previous,primal,primeval,primordial,proterozoic,proto,ripe,untimely,wee
late.a.01	advanced,after-hours,late,posthumous,ripe	aboriginal,advance,archaean,archean,beforehand,earlier,earliest,early,intervening,mid,middle,premature,previous,primal,primeval,primordial,proterozoic,proto,untimely,wee
early.a.02	archaic,crude,early,embryonic,inchoate,incipient,new,precocious,primitive,rude,young	advanced,late,later,tardive
east.a.01	east,eastbound,easterly,eastern,easternmost,eastside,eastward	west,westbound,westerly,western,westernmost,westside,westward
western.a.02	midwestern,northwestern,southwestern,west-central,western	east-central,eastern,northeastern,southeastern
educated.a.01	educated,knowing,knowledgeable,learned,lettered,literate,self-educated,semiliterate,well-educated,well-read	ignorant,illiterate,undereducated,uneducated,unlearned,unlettered,unschooled,unstudied,untutored
operative.a.01	effective,good,operant,operating,operational,operative,working	dead,defunct,down,inoperative
effective.a.01	effective,effectual,efficacious,hard-hitting,impelling,impressive,telling,trenchant	ineffective,ineffectual,toothless,unproductive
effortful.a.01	arduous,backbreaking,dragging,effortful,exhausting,grueling,gruelling,hard,heavy,labor-intensive,labored,laborious,labour-intensive,laboured,leaden,plodding,punishing,straining,strenuous,tiring,wearing,wearying	effortless,facile,unforced,unstrained
efficient.a.01	businesslike,cost-effective,cost-efficient,economic,economical,efficient,expeditious,high-octane,streamlined	inefficient,uneconomical,wasteful
elective.a.01	elected,elective,electoral	appointed,appointive,nominated,nominative,nonelected
optional.a.01	elective,facultative,optional	compulsory,imposed,indispensable,mandatory,obligatory,prerequisite,required
elegant.a.01	dandified,dandyish,deluxe,elegant,exquisite,fine,foppish,high-class,luxe,neat,recherche,refined,ritzy,soigne,tasteful	gauche,graceless,homely,inelegant,unpolished
eligible.a.01	bailable,desirable,eligible,entitled,legal,pensionable,suitable,worthy	disqualified,ineligible,undesirable,unqualified,unsuitable
emotional.a.02	affective,bathetic,cathartic,charged,drippy,emotional,emotive,funky,hokey,hot-blooded,kitschy,little,low-down,lyric,lyrical,maudlin,mawkish,mind-blowing,moody,mushy,releasing,schmaltzy,sentimental,sloppy,slushy,soppy,soulful,soupy,supercharged,temperamental	chilly,dry,impassive,philosophic,philosophical,phlegmatic,stoic,stoical,stolid,unblinking,unemotional
empirical.a.01	confirmable,empiric,empirical,existential,experiential,experimental,falsifiable,observational,trial-and-error,verifiable	conjectural,divinatory,hypothetical,metaphysical,notional,speculative,supposed,theoretic,theoretical
theoretical.a.02	abstract,academic,pure,theoretical	applied,forensic,practical
employed.a.01	employed,engaged,hired,working	discharged,dismissed,fired,idle,jobless,laid-off,unemployed
enchanted.a.01	beguiled,bewitched,captivated,charmed,delighted,enchanted,enthralled,entranced,fascinated,hypnotised,hypnotized,mesmerised,mesmerized,spellbound,transfixed	disabused,disenchanted,disillusioned
encouraging.a.01	encouraging,heartening,hortatory,promotive,rallying	daunting,demoralising,demoralizing,discouraging,disheartening,dispiriting,frustrating,intimidating
encumbered.a.01	burdened,clogged,encumbered,involved,mired,mortgaged	clear,unburdened,unencumbered
energetic.a.01	alert,brisk,canty,driving,energetic,high-energy,indefatigable,lively,merry,physical,rattling,snappy,spanking,strenuous,tireless,unflagging,vigorous,zippy	dazed,dreamy,foggy,groggy,lackadaisical,languid,languorous,lethargic,listless,logy
increased.a.01	accrued,accumulated,augmented,elevated,enhanced,enlarged,exaggerated,hyperbolic,increased,inflated,magnified,multiplied,raised,redoubled	ablated,attenuate,attenuated,bated,belittled,cut,decreased,diminished,faded,minimized,reduced,shriveled,shrivelled,shrunken,slashed,small,weakened
enthusiastic.a.01	ardent,avid,crazy,dotty,enthusiastic,evangelical,evangelistic,gaga,glowing,overenthusiastic,warm,wild,zealous	cold,half-hearted,halfhearted,lukewarm,tepid,unenthusiastic
equal.a.01	close,coequal,coordinate,equal,equidistant,equilateral,equivalent,even,fifty-fifty,isochronous,isometric,isothermal,level,quits,tantamount,tied,tight	mismatched,odds-on,unbalanced,unequal,uneven,unsymmetrical
balanced.a.01	balanced,counterbalanced,harmonious,poised,proportionate,self-balancing,stable,symmetrical,well-balanced	imbalanced,labile,unbalanced
equivocal.a.01	ambiguous,double,equivocal,evasive,forked,indeterminate	absolute,straightforward,unambiguous,unequivocal,univocal,unquestionable
essential.a.02	basal,biogenic,constituent,constitutional,constitutive,essential,life-sustaining,must,no-frills,organic,primary,staple,substantial,substantive,virtual,vital	incidental,inessential,nonessential,unessential
complimentary.a.01	complimentary,eulogistic,laudatory,panegyric,praising	belittling,deprecating,deprecatory,derogative,derogatory,disparaging,pejorative,slighting,sneering,snide,supercilious,uncomplimentary
even.a.03	even,flat,flush,justified,level,plane,straight,true	crinkled,crinkly,irregular,jagged,lumpy,patchy,ragged,rippled,uneven,untrue,wavelike,wavy
evergreen.a.01	coniferous,evergreen,semi-evergreen	broad-leaved,broadleaf,deciduous
exact.a.01	direct,exact,literal,mathematical,perfect,photographic,rigorous,strict,verbatim	approximate,free,inexact,liberal,loose,odd,rough,round
exciting.a.01	breathless,breathtaking,electric,electrifying,exciting,exhilarating,galvanic,galvanising,galvanizing,glamorous,glamourous,heady,intoxicating,thrilling,tickling,tingling,titillating	commonplace,humdrum,prosaic,tame,unexciting,unglamorous,uninspired
exculpatory.a.01	exculpatory,extenuating,forgiving	accusative,accusatory,accusing,condemnatory,condemning,damning,incriminating
existent.a.01	active,alive,existent,existing	absent,barren,destitute,devoid,free,innocent,lacking,missing,nonexistent,vanished,wanting
expected.a.01	anticipated,awaited,due,expectable,expected,hoped-for	unannounced,unanticipated,unexpected,unforeseen,unheralded,unpredicted,upset
expensive.a.01	costly,dear,expensive,high-priced,overpriced,pricey,pricy	affordable,cheap,cut-price,cut-rate,inexpensive,low-budget,low-cost,low-priced,sixpenny,threepenny
experienced.a.01	experienced,full-fledged,intimate,knowledgeable,old,older,practiced,practised,seasoned,versed,veteran	callow,fledgling,inexperienced,naive,new,raw,uninitiated,unpracticed,unseasoned,untested,untried,unversed,young
explicable.a.01	explainable,explicable,interpretable	cryptic,deep,incomprehensible,inexplicable,inscrutable,mysterious,mystifying,paradoxical,self-contradictory,unaccountable,unexplainable,unexplained
explicit.a.01	declared,definitive,explicit,express,expressed,graphic,hard-core,hardcore,stated,unequivocal	implicit,inherent,silent,tacit,underlying,understood,unexpressed,unsaid,unspoken,unstated,unvoiced
expressible.a.01	describable,expressible,representable	indefinable,indescribable,ineffable,inexpressible,unspeakable,unutterable
external.a.01	external,outer,outside	inner,interior,internal,internecine,intrinsic
outer.a.01	out,outer,outermost,outmost,outside,satellite	inmost,inner,innermost,inside
outward.a.01	external,outer,outward	indwelling,inmost,inner,innermost,interior,internal,inward,private,secret
exterior.a.01	exterior,out,outside	indoor,inside,interior
fair.a.01	antimonopoly,antitrust,clean,fair,fair-minded,just,sporting,sportsmanlike,sporty	cheating,dirty,foul,raw,unfair,unjust,unsporting,unsportsmanlike
faithful.a.01	faithful,fast,firm,loyal,true	apostate,perfidious,punic,treacherous,unfaithful,untrue
loyal.a.01	allegiant,doglike,hard-core,hardcore,leal,liege,loyal	disloyal,faithless,insurgent,mutinous,rebellious,renegade,seditious,subversive,traitorous,treasonable,treasonous,unfaithful
fallible.a.01	errant,erring,error-prone,fallible,undependable,unreliable,weak	foolproof,inerrant,infallible,unerring,unfailing
familiar.a.01	acquainted,beaten,familiar,old,well-known	strange,unacquainted,unfamiliar,unknown
strange.a.01	antic,crazy,curious,eerie,eery,exotic,fantastic,fantastical,freaky,funny,gothic,grotesque,odd,other,peculiar,quaint,queer,rum,rummy,singular,strange,unusual,weird	common,everyday,familiar,usual
fashionable.a.01	cool,cutting-edge,dapper,dashing,faddish,fashionable,groovy,in,jaunty,latest,mod,modern,modernistic,modish,natty,old-time,quaint,raffish,rakish,snappy,spiffy,spruce,stylish,swagger,swank,swanky,trend-setting,trendsetting,trendy,up-to-date,voguish	antique,dated,dowdy,ex,frumpy,mossy,old-fashioned,out,outmoded,passe,prehistoric,stodgy,unfashionable,unstylish
fast.a.01	accelerated,blistering,express,fast,fast-paced,fleet,high-speed,high-velocity,hot,hurrying,immediate,instant,instantaneous,meteoric,prompt,quick,rapid,red-hot,scurrying,smart,speedy,straightaway,swift,windy,winged	dilatory,drawn-out,laggard,lazy,long-play,long-playing,pokey,poky,slow,slow-moving,sluggish,sulky
fast.a.03	allegretto,allegro,andantino,fast,presto,vivace	adagio,andante,larghetto,largo,lento,moderato,slow
fat.a.01	blubbery,buxom,chubby,corpulent,dumpy,fat,fleshy,gross,heavy,jowly,obese,overweight,paunchy,plump,porcine,portly,potbellied,pudgy,roly-poly,rotund,stout,tubby,weighty,zaftig	anorectic,anorexic,boney,bony,cadaverous,emaciated,gangling,gangly,gaunt,haggard,lank,lanky,lean,pinched,rawboned,reedy,scrawny,shriveled,shrivelled,shrunken,skeletal,skinny,slender,slight,slim,spare,spindly,stringy,svelte,thin,trim,twiggy,underweight,wasted,weedy,wiry,wispy,withered,wizened
fatty.a.01	adipose,buttery,fat,fatty,greasy,oily,oleaginous,sebaceous	fat-free,light,lite,nonfat,skim,skimmed
favorable.a.02	favorable,favourable,following	adverse,contrary,unfavorable,unfavourable
favorable.a.01	affirmative,approving,favorable,favourable,indulgent	admonishing,admonitory,adverse,disapproving,discriminatory,inauspicious,invidious,reproachful,reproving,unfavorable,unfavourable,untoward
feathered.a.02	feathered,featherlike,feathery,fledged,flighted,pennate,plumaged,plumed	featherless,plucked,unfeathered
felicitous.a.01	congratulatory,felicitous,happy,well-chosen	awkward,clumsy,cumbersome,inapt,inept,infelicitous,unfortunate
fertile.a.01	fecund,fertile,impregnable,rank	barren,infertile,sterile,sterilised,sterilized,unfertilised,unfertilized
finished.a.02	complete,concluded,done,ended,finished,over,terminated,through,up	incomplete,pending,uncompleted,undone,unfinished
finished.a.01	dressed,fattened,fattening,finished,polished	raw,rough-cut,roughhewn,undressed,unfinished
finite.a.01	bounded,delimited,exhaustible,finite,impermanent,limited	boundless,dateless,endless,inexhaustible,infinite,limitless,unbounded,unlimited
opening.a.01	beginning,first,inaugural,initiative,initiatory,introductory,maiden,opening,starting	closing,concluding,final,last,terminal,year-end
first.a.01	archetypal,archetypical,basic,eldest,first,first-year,firstborn,freshman,initial,introductory,original,premier,premiere,prime,prototypical	fourth-year,last,senior,sunset,ultimate
fit.a.03	able,able-bodied,conditioned,fit	afflicted,bandy,bowed,bowlegged,crippled,dipped,disabled,flabby,flaccid,game,gibbous,gimpy,halt,halting,handicapped,humpbacked,humped,hunchbacked,impaired,lame,maimed,mutilated,soft,unfit
fit.a.01	acceptable,fit,suitable,suited,worthy	subhuman,unfit,unsuitable
flexible.a.02	bendable,flexible,limber,pliable,pliant,stretched,supple,waxy	inflexible,muscle-bound,rigid,stiff
flexible.a.01	flexible,limber,negotiable,supple	adamant,adamantine,die-hard,fossilised,fossilized,hard-core,inexorable,inflexible,intransigent,ironclad,ossified
uncompromising.a.01	hard-line,hardline,inflexible,sturdy,uncompromising	compromising,conciliatory,flexible,yielding
adaptable.a.01	adaptable,adjustable,convertible,elastic,flexible,pliable,pliant,universal,variable	inflexible,rigid,unbending
foreign.a.02	alien,established,exotic,foreign,foreign-born,imported,naturalized,nonnative,strange	autochthonous,domestic,endemic,homegrown,indigenous,native,native-born
foreign.a.01	abroad,external,foreign,international,outside,overseas	domestic,home,interior,internal,municipal,national
forgiving.a.01	forgiving,kind,tolerant	revengeful,unforgiving,vengeful,vindictive
formal.a.01	black-tie,buckram,ceremonial,ceremonious,conventional,dress,formal,full-dress,nominal,perfunctory,positive,prescribed,semi-formal,semiformal,starchy,stiff,titular	casual,daily,everyday,folksy,informal,unceremonious
fortunate.a.01	felicitous,fortuitous,fortunate,good,happy,lucky,miraculous,providential,well,well-off	abject,black,calamitous,disastrous,dispossessed,doomed,downtrodden,fatal,fateful,hapless,homeless,ill-fated,infelicitous,miserable,misfortunate,pathetic,piteous,pitiable,pitiful,poor,regrettable,roofless,unfortunate,unhappy,unlucky,wretched
fragrant.a.01	aromatic,fragrant,musky,odoriferous,odorous,perfumed,redolent,scented,sweet,sweet-smelling	fetid,foul,foul-smelling,funky,fusty,gamey,gamy,high,malodorous,musty,noisome,odoriferous,odorous,rancid,reeking,smelly,sour,stinking,stinky
odorous.a.01	odorous,redolent,scented,smelling	odorless,odourless,scentless
free.a.02	free,liberated,unbound	bound,conjugate,conjugated
fixed.a.03	fast,firm,fixed,geostationary,geosynchronous,immobile,leaded,stationary,taped	detached,floating,free,unfixed,unsteady
free.a.01	autonomous,available,aweigh,clear,emancipated,escaped,footloose,free,independent,liberated,loose,out-of-school,self-governing,sovereign,uncommitted,unconfined,unconstrained,unhampered,unrestricted	apprenticed,articled,bound,captive,confined,cornered,entangled,imprisoned,indentured,jailed,prisonlike,trapped,treed,unfree
frequent.a.01	dominant,frequent,predominant,prevailing,prevalent,regular,rife,steady	infrequent,occasional,rare
fresh.a.01	caller,crisp,fresh,good,hot,strong,unspoiled,unspoilt,warm	addled,bad,cold,corrupt,day-old,hard,limp,moldy,mouldy,musty,putrid,rancid,rotten,spoiled,spoilt,stale,tainted,wilted
friendly.a.01	affable,amiable,chummy,companionate,comradely,cordial,cozy,friendly,genial,informal,intimate,matey,neighborly,neighbourly,pally,social	chilly,scowling,unfriendly
frozen.a.01	frostbitten,frozen,glaciated,icebound,icy	ice-free,melting,slushy,thawed,unfrozen
fruitful.a.01	berried,bountiful,breeding,fat,fertile,fruitful,generative,high-yield,plentiful,procreative,productive,prolific,reproductive,rich	abortive,childless,stillborn,unfruitful,unsuccessful
full.a.01	afloat,air-filled,awash,brimful,brimming,chockablock,congested,engorged,filled,flooded,fraught,full,gas-filled,glutted,heavy,instinct,inundated,laden,loaded,overflowing,overladen,overloaded,pregnant,replete,riddled,stuffed,untouched	bare,blank,clean,empty,empty-handed,glassy,glazed,lifeless,looted,pillaged,plundered,ransacked,stripped,vacant,vacuous,void,white
functional.a.01	functional,structural,useful,utilitarian	cosmetic,decorative,nonfunctional,nonstructural,ornamental
functioning.a.01	functional,functioning,operative,running,up,working	amiss,awry,bad,defective,haywire,malfunctioning,nonfunctional,run-down,wrong
general.a.01	all-purpose,broad,general,general-purpose,generic,gross,overall,pandemic,universal,unspecific,widespread	circumstantial,limited,particular,particularized,peculiar,proper,special,specific,unique
nonproprietary.a.01	generic,nonproprietary,unpatented	branded,copyrighted,patented,proprietary,trademarked
generous.a.01	benevolent,big,bighearted,bounteous,bountiful,generous,giving,handsome,lavish,liberal,munificent,overgenerous,unselfish,unsparing,unstinted,unstinting	cheap,chintzy,close,grudging,mean,miserly,near,niggardly,parsimonious,penurious,skinny,stingy,tight,tightfisted,ungenerous
genuine.a.01	attested,authentic,authenticated,documented,echt,genuine,good,honest,old,unquestionable,veritable	assumed,bad,base,bastard,bogus,counterfeit,fake,false,fictitious,fictive,forged,imitative,inauthentic,mock,ostensible,phoney,phony,pinchbeck,pretended,pseudo,sham,spurious,synthetic,unauthentic
glorious.a.01	bright,celebrated,divine,elysian,empyrean,glorious,illustrious,incandescent,inspired,lustrous,storied,sublime	inglorious,obscure,unknown,unsung
good.a.01	acceptable,bully,corking,cracking,dandy,good,great,groovy,hot,keen,neat,nifty,peachy,redeeming,satisfactory,smashing,solid,superb,swell,well-behaved	abominable,atrocious,awful,bad,corked,corky,crappy,deplorable,distressing,dreadful,fearful,frightful,hard,hopeless,horrid,icky,ill,incompetent,lamentable,lousy,mediocre,naughty,negative,no-good,painful,pitiful,poor,pretty,rotten,rubber,sad,severe,shitty,sorry,stinking,stinky,swingeing,terrible,tough,uncool,unfavorable,unfavourable,unskilled,unspeakable,unsuitable
good.a.03	angelic,beatific,good,redeeming,redemptive,sainted,saintly,saving,white	atrocious,bad,black,corruptive,dark,demonic,despicable,devilish,diabolic,diabolical,evil,fiendish,grievous,hellish,infernal,mephistophelean,monstrous,satanic,sinister,slimy,ugly,unholy,unworthy,vile,worthless,wretched
good-natured.a.01	amiable,equable,even-tempered,good-humored,good-humoured,good-natured,placid	bad-tempered,bilious,bristly,cantankerous,choleric,churlish,crabbed,crabby,cranky,cross,crotchety,crusty,curmudgeonly,dark,disagreeable,dour,dyspeptic,fractious,fussy,glowering,glum,grouchy,gruff,grumpy,hot-tempered,hotheaded,ill-tempered,irascible,irritable,misanthropic,misogynistic,misogynous,moody,morose,nagging,nettlesome,ornery,peckish,peevish,petulant,prickly,quick-tempered,saturnine,scratchy,short-tempered,shrewish,snappish,snappy,sour,splenetic,spoiled,spoilt,sulky,sullen,surly,techy,testy,tetchy,ugly,vinegary,waspish
graceful.a.01	elegant,fluent,fluid,graceful,gracile,liquid,lissome,lithe,slender,smooth,supple,svelte,willowy	awkward,clumsy,clunky,gawky,graceless,labored,laboured,strained,ungainly,ungraceful,unwieldy,wooden
gracious.a.01	elegant,graceful,gracious,merciful,refined	churlish,graceless,ungracious,unpleasing
gradual.a.01	gradual,graduated,piecemeal,step-by-step,stepwise	abrupt,choppy,emergent,explosive,fulminant,jerky,sharp,sudden
gradual.a.02	easy,gentle,gradual,sloping	abrupt,bluff,bold,heavy,perpendicular,precipitous,sharp,sheer,steep,steep-sided
grateful.a.01	appreciative,glad,grateful,thankful	thankless,unappreciative,ungrateful
happy.a.01	blessed,blissful,bright,golden,halcyon,happy,laughing,prosperous	lovesick,miserable,suffering,unhappy,wretched
hard.a.03	adamantine,erect,firm,granitic,hard,hardened,horny,petrous,rocklike,set,solid,steely,stony,unyielding,woody	brushed,compressible,cottony,cushioned,cushiony,downy,emollient,flaccid,fleecy,flossy,fluffy,mushy,napped,overstuffed,padded,salving,semisoft,soft,softening,spongelike,spongy,squeezable,squishy,velvet,velvety,woolly,wooly,yielding
harmless.a.01	harmless,innocent,innocuous	abusive,bad,bruising,catastrophic,counterproductive,damaging,defamatory,deleterious,denigrating,detrimental,harmful,hurtful,ill,injurious,insidious,libellous,libelous,mischievous,pernicious,prejudicial,ruinous,slanderous,stabbing,subtle,wounding
harmonious.a.01	consonant,harmonic,harmonious,harmonised,harmonized,pure,sympathetic,symphonic,true	discordant,disharmonious,dissonant,false,inharmonious,off-key,sour,unresolved
healthful.a.01	alterative,anthelmintic,antimicrobial,cathartic,curative,good,healing,healthful,medicinal,organic,orthomolecular,preventative,preventive,prophylactic,psychotherapeutic,recuperative,remedial,restorative,salutary,therapeutic	crippling,disabling,incapacitating,infective,pathogenic,unhealthful,unhealthy
healthy.a.01	bouncing,firm,florid,flushed,full-blooded,good,hale,healthy,hearty,lusty,rosy,ruddy,sanguine,sound,well-preserved,whole,wholesome	angry,arthritic,asthmatic,bad,bloodshot,colicky,creaky,dehydrated,diseased,enlarged,flatulent,foaming,foamy,frothing,gangrenous,gassy,inflamed,inflammatory,ingrown,jaundiced,membranous,mental,morbid,mortified,pathologic,pathological,pro-inflammatory,proinflammatory,puffy,rheumatic,rheumatoid,rheumy,sallow,sickly,sunburned,sunburnt,tumescent,turgid,ulcerated,unfit,unhealthy,unsound,varicose,wheezing,wheezy,yellow
heavenly.a.03	ambrosial,ambrosian,celestial,divine,ethereal,godlike,godly,heavenly,paradisiacal,providential,supernal	earthbound,earthlike,earthly,mundane,temporal,terrestrial
digestible.a.01	digestible,light,predigested	flatulent,heavy,indigestible,stodgy,undigested
heavy.a.01	dense,doughy,heavier-than-air,heavy,hefty,massive,ponderous,soggy	airy,buoyant,floaty,light,lighter-than-air,lightweight,low-density
heavy.a.04	burdensome,distressful,distressing,disturbing,heavy,leaden,onerous,oppressive,perturbing,taxing,troubling,weighted,weighty,worrisome,worrying	casual,fooling,light
heterogeneous.a.01	assorted,disparate,heterogeneous,heterogenous,inhomogeneous,miscellaneous,mixed,motley,nonuniform,sundry	consistent,homogeneous,homogenized,homogenous,solid,uniform
homosexual.a.01	butch,gay,homoerotic,homophile,homosexual,lesbian,pederastic,queer,sapphic,transgender,transgendered,transsexual,transvestite	bisexual,heterosexual,straight
hierarchical.a.01	class-conscious,graded,hierarchal,hierarchic,hierarchical,ranked,stratified,vertical	ungraded,unordered,unranked
high.a.02	commanding,dominating,eminent,high,high-altitude,high-level,lofty,overlooking,soaring,steep,towering,upper	deep,low,low-altitude,low-growing,low-level,low-lying,low-set,nether,squat,under,underslung
high.a.01	advanced,broad,full,graduate,high,higher,last,postgraduate,soaring,utmost	debased,degraded,depressed,devalued,down,low,low-level,reduced
high.a.04	adenoidal,altissimo,alto,countertenor,falsetto,high,high-pitched,nasal,peaky,pinched,screechy,sharp,shrill,sopranino,soprano,spiky,squeaking,squeaky,squealing,tenor,treble	alto,baritone,bass,contrabass,contralto,deep,double-bass,low,low-pitched,throaty
upland.a.01	alpine,highland,mountainous,subalpine,upland	low-lying,lowland,sea-level
honest.a.01	downright,honest,honorable	ambidextrous,beguiling,deceitful,deceptive,dishonest,dishonorable,double-dealing,duplicitous,fallacious,false,fraudulent,misleading,picaresque,rascally,roguish,shoddy,thieving,two-faced
honorable.a.02	august,honorable,honourable,laureate,revered,time-honored,time-honoured,venerable	black,debasing,degrading,disgraceful,dishonorable,dishonourable,ignominious,inglorious,shabby,shameful,unprincipled,yellow
horizontal.a.01	crosswise,flat,horizontal,level,swimming	canted,diagonal,high-pitched,inclined,leaning,low-pitched,perpendicular,pitched,plumb,salient,sidelong,skew,skewed,slanted,slanting,sloped,sloping,tilted,tipped,upended,upright,vertical
vertical.a.01	perpendicular,plumb,upended,upright,vertical	canted,crosswise,diagonal,flat,high-pitched,horizontal,inclined,leaning,level,low-pitched,pitched,salient,sidelong,skew,skewed,slanted,slanting,sloped,sloping,swimming,tilted,tipped
inclined.a.02	canted,diagonal,high-pitched,inclined,leaning,low-pitched,pitched,salient,sidelong,skew,skewed,slanted,slanting,sloped,sloping,tilted,tipped	crosswise,flat,horizontal,level,perpendicular,plumb,swimming,upended,upright,vertical
erect.a.01	erect,erectile,orthostatic,passant,rampant,rearing,stand-up,standing,straight,unbowed,upright,vertical	bended,bent,crooked,decumbent,dormant,drooping,flat,hunched,nodding,pendulous,procumbent,prone,prostrate,recumbent,sleeping,stooped,stooping,supine,weeping
running.a.01	gushing,jetting,pouring,running,spouting,spurting,squirting	dead,slack,stagnant,standing,still
hospitable.a.01	genial,hospitable,kind	bare,barren,bleak,desolate,godforsaken,hostile,inhospitable,stark,uncongenial,unfriendly,waste,wild,windswept
hostile.a.01	aggressive,antagonistic,antipathetic,belligerent,bitter,dirty,head-on,hostile,ill,inimical,opponent,opposing,unfriendly	amicable,favorable,friendly,unthreatening,well-disposed,well-meaning
hot.a.01	baking,blistering,calorific,fervent,fervid,fiery,heated,het,hot,igneous,overheated,red-hot,scorching,sizzling,stifling,sulfurous,sulphurous,sultry,sweltering,thermal,torrid,tropic,tropical,warming,white,white-hot	arctic,bleak,chilly,cold,crisp,cutting,frigid,frosty,gelid,glacial,ice-cold,icy,nipping,nippy,polar,raw,refrigerant,refrigerated,refrigerating,shivery,snappy,unheated
hot.a.03	fiery,flaming,heated,hot,red-hot,sensual,sizzling,sultry,torrid,white-hot	cold,emotionless,frigid,frosty,frozen,glacial,icy,passionless,wintry
human.a.03	anthropoid,anthropomorphic,fallible,frail,hominid,human,humanlike,imperfect,weak	anthropoid,apelike,bloodless,dehumanised,dehumanized,inhuman,nonhuman
humane.a.02	child-centered,human-centered,humane,humanist,humanistic,humanitarian	barbarous,beastly,bestial,brutal,brute,brutish,cold,cold-blooded,cruel,fell,inhuman,inhumane,insensate,pitiless,roughshod,savage,unkind,vicious
humorous.a.01	amusing,bantering,buffoonish,clownish,comic,comical,droll,dry,facetious,farcical,funny,hilarious,humorous,humourous,ironic,ironical,jesting,jocular,joking,killing,laughable,ludicrous,mirthful,ridiculous,risible,screaming,seriocomic,sidesplitting,slapstick,tongue-in-cheek,tragicomic,uproarious,waggish,witty,wry,zany	humorless,humourless,unfunny
hurried.a.01	fast,flying,hasty,headlong,hurried,precipitate,precipitous,quick,rush,rushed	careful,deliberate,easy,easygoing,leisurely,measured,unhurried
identifiable.a.01	classifiable,diagnosable,distinctive,identifiable,recognisable,recognizable	elusive,intangible,unclassifiable,unidentifiable,unrecognisable,unrecognizable
important.a.01	all-important,alpha,beta,big,burning,cardinal,central,chief,consequential,crucial,distinguished,essential,eventful,fundamental,grand,grave,great,grievous,heavy,historic,important,key,main,master,measurable,outstanding,primal,primary,principal,serious,strategic,weighty	fiddling,immaterial,inconsequential,indifferent,lightweight,lilliputian,little,niggling,petty,picayune,piddling,potty,small-time,trivial,unimportant
noticeable.a.01	broad,detectable,discernible,evident,marked,noted,noticeable,observable,perceptible,pronounced	insignificant,undistinguished,unnoticeable
improved.a.01	built,developed,improved,landscaped,reinforced	dirt,scrub,ungraded,unimproved
inclined.a.01	accident-prone,apt,disposed,fond,given,inclined,minded,partial,prone,tending	afraid,antipathetic,averse,disinclined,indisposed,loath,loth,reluctant
incoming.a.01	designate,elect,future,in,inbound,incoming,inflowing,influent,inward,next,succeeding	effluent,out,outbound,outflowing,outgoing,outward,past,preceding,retiring
indulgent.a.01	betting,decadent,dissipated,effete,epicurean,gay,hard,heavy,hedonic,hedonistic,indulgent,intemperate,luxuriant,luxurious,overindulgent,pampering,self-indulgent,sporting,sybaritic,voluptuary,voluptuous	austere,blue,corrective,disciplinary,monkish,puritanical,self-denying,severe,spartan,stern,strict
informed.a.01	abreast,advised,conversant,educated,enlightened,familiar,hep,hip,informed,knowing,knowledgeable,privy,well-read,wise	clueless,ignorant,innocent,naive,unacquainted,unenlightened,uninformed,unknowing,unread,unwitting
ingenuous.a.01	artless,candid,heart-to-heart,ingenuous,open,undistorted	artful,disingenuous,distorted,misrepresented,perverted,twisted
inhabited.a.01	colonised,colonized,haunted,inhabited,occupied,owner-occupied,peopled,populated,populous,settled,tenanted,underpopulated	abandoned,depopulated,derelict,deserted,lonely,solitary,uninhabited,unoccupied,unpopulated,unsettled
inheritable.a.01	ancestral,familial,genetic,hereditary,heritable,inheritable,inherited,inheriting,monogenic,nee,patrimonial,polygenic,transmissible,transmitted	acquired,congenital,inborn,innate
inhibited.a.01	inhibited,pent-up,repressed,smothered,stifled,strangled,suppressed	abandoned,earthy,uninhibited
injured.a.01	disjointed,dislocated,eviscerate,hurt,injured,lacerate,lacerated,livid,mangled,raw,separated,torn,wounded	intact,inviolate,uncut,unharmed,unhurt,uninjured,unscathed,unwounded,whole
innocent.a.01	absolved,acquitted,blameless,clear,cleared,exonerated,guiltless,innocent,irreproachable,unimpeachable,vindicated	blameworthy,chargeable,criminal,culpable,delinquent,guilt-ridden,guilty,indictable,punishable,red-handed
integrated.a.03	co-ed,coeducational,integrated,interracial,mainstreamed,mixed	isolated,quarantined,segregated,separate,sequestered,white
intellectual.a.02	good,highbrow,intellectual,rational,reflective,serious,sophisticated	anti-intellectual,lowbrow,mindless,philistine,uncultivated
intelligent.a.01	agile,apt,born,brainy,bright,brilliant,clever,innate,intelligent,natural,nimble,prehensile,quick,ready,scintillating,searching,smart,trenchant	brainless,headless,stupid,unintelligent
intended.a.01	calculated,conscious,deliberate,intended,intentional,knowing,measured,well-intentioned,well-meaning,witting	accidental,fortuitous,inadvertent,unintended,unintentional,unplanned,unwitting
intensifying.a.01	aggravating,augmentative,deepening,exacerbating,exasperating,heightening,intensifying,thickening	analgesic,anodyne,moderating,palliative,tempering,weakening
interesting.a.01	absorbing,amusing,diverting,engrossing,entertaining,fascinating,gripping,interesting,intriguing,newsworthy,riveting	boring,deadening,dull,earthbound,insipid,irksome,jejune,narcotic,pedestrian,ponderous,prosaic,slow,soporific,tedious,tiresome,uninteresting,wearisome
intramural.a.01	internal,intragroup,intramural	extramural,intercollegiate,interscholastic,interschool,outside
intrinsic.a.01	built-in,constitutional,inbuilt,inherent,inner,integral,internal,intimate,intrinsic	adventitious,alien,external,extraneous,extrinsic,foreign,outside
invigorating.a.01	animating,bracing,brisk,enlivening,exhilarating,fresh,invigorating,life-giving,refreshing,renewing,restorative,revitalising,revitalizing,reviving,stimulating,tonic,vitalizing	debilitating,draining,enervating,exhausting,weakening
joyful.a.01	beatific,joyful,overjoyed	anguished,bereaved,bereft,bitter,brokenhearted,dolorous,elegiac,grief-stricken,grieving,grievous,heartbreaking,heartbroken,heartrending,heartsick,lachrymose,lamenting,lugubrious,mournful,mourning,plaintive,sad,sorrowful,sorrowing,tearful,tormented,tortured,wailing,weeping,woebegone,woeful
joyous.a.01	ecstatic,elated,enraptured,festal,festive,gay,gleeful,jolly,jovial,joyful,joyous,jubilant,merry,mirthful,rapt,rapturous,rhapsodic	funereal,joyless,mirthless,sepulchral,unsmiling
just.a.01	fitting,just,meet,retributive,rightful	actionable,unjust,wrongful
kind.a.01	benevolent,benign,charitable,gentle,good-hearted,gracious,kind,kind-hearted,kindhearted,kindly,openhearted,sympathetic	cutting,edged,harsh,hurtful,rough,stinging,unkind,unkindly,unsympathetic
known.a.01	best-known,better-known,celebrated,famed,famous,identified,illustrious,known,legendary,notable,noted,proverbial,renowned,well-known	little-known,unbeknown,unbeknownst,uncharted,undiagnosed,undiscovered,unexplored,unheard-of,unidentified,unknown,unmapped
large.a.01	ample,astronomic,astronomical,banging,big,bigger,blown-up,bouffant,broad,bulky,capacious,colossal,cosmic,deep,double,elephantine,enlarged,enormous,epic,extended,extensive,full-size,galactic,gargantuan,giant,gigantic,grand,great,heroic,huge,hulking,humongous,immense,jumbo,king-size,large,large-scale,larger,larger-than-life,largish,life-size,life-sized,lifesize,macro,macroscopic,mammoth,man-sized,massive,medium-large,monolithic,monstrous,monumental,mountainous,outsize,outsized,oversize,oversized,plumping,prodigious,puffy,rangy,sizable,sizeable,spacious,stupendous,super,thumping,titanic,tremendous,vast,voluminous,walloping,whacking,whopping,wide,wide-ranging	atomic,bantam,bitty,diminutive,dinky,dwarfish,elfin,flyspeck,gnomish,half-size,infinitesimal,lesser,lilliputian,little,littler,micro,microscopic,microscopical,midget,miniature,miniscule,minuscule,minute,petite,pocket-sized,puny,runty,slender,slim,small,small-scale,smaller,smallish,subatomic,teensy,teeny,tiny,undersize,undersized,wee,weensy,weeny
lawful.a.01	law-abiding,lawful,observant	lawless,outlaw,unlawful,wide-open,wrongful
leaky.a.01	drafty,draughty,drippy,holey,leaky,oozing,oozy,porous,seeping	air-tight,airtight,hermetic,leakproof,snug,tight,waterproof,waterproofed,watertight
leeward.a.01	downwind,lee,leeward	upwind,weather,windward
legal.a.01	court-ordered,judicial,juristic,lawful,legal,legitimate,licit,ratified,sanctioned,statutory	banned,black,black-market,bootleg,contraband,criminal,dirty,embezzled,extrajudicial,extralegal,felonious,hot,ill-gotten,illegal,illegitimate,illicit,ineligible,misappropriated,misbranded,mislabeled,nonlegal,outlaw,outlawed,penal,prohibited,punishable,smuggled,unlawful,unratified
legible.a.01	clean,clear,decipherable,fair,legible,readable	dirty,foul,illegible,indecipherable,unclear,undecipherable,unreadable
biological.a.02	begotten,biological,natural	adoptive,foster,surrogate
legitimate.a.01	lawful,left-handed,legitimate,morganatic,rightful,true	base,fatherless,illegitimate,left-handed,misbegotten,spurious,unlawful,wrongful
like.a.01	like,like-minded,look-alike,similar,suchlike	different,dissimilar,unlike
likely.a.01	apt,liable,likely,probable,promising	farfetched,implausible,last,outside,remote,unlikely
probable.a.01	likely,presumptive,probable	improbable,supposed,unlikely
limited.a.01	limited,minor,modest,narrow,pocket-sized,small,small-scale	bottomless,limitless,oceanic,unlimited,untrammeled,untrammelled
live.a.01	live,unfilmed,unrecorded	canned,filmed,prerecorded,recorded,tape-recorded,taped,transcribed
loaded.a.02	live,loaded,unexploded	blank,dud,unloaded
logical.a.01	discursive,formal,logical	absurd,illogical,inconsequential,intuitive,nonrational,visceral
long.a.02	elongate,elongated,extendable,extended,extendible,far,lank,lengthened,long,long-handled,long-range,long-snouted,oblong,polysyllabic,prolonged,stretch	abbreviated,brief,close,sawed-off,short,short-range,shortened,shortish,snub,stubby,telescoped,truncate,truncated
long.a.01	all-night,chronic,continuing,daylong,drawn-out,durable,eight-day,endless,eternal,extended,hourlong,interminable,lasting,lengthy,lifelong,long,long-acting,long-lasting,long-life,long-lived,long-range,long-run,long-term,longish,longitudinal,longstanding,monthlong,nightlong,overnight,perennial,prolonged,protracted,semipermanent,seven-day,time-consuming,weeklong,yearlong	abbreviated,brief,clipped,fleeting,fugitive,momentary,short,short-range,short-run,short-term,shortened,truncated
lengthwise.a.01	axial,end-to-end,fore-and-aft,lengthwise,linear,longitudinal,running	cross,cross-section,cross-sectional,crosswise,transversal,transverse
loose.a.03	baggy,flyaway,loose,loose-fitting,sloppy	clenched,clinched,close,close-fitting,skin-tight,skinny,skintight,snug,tight,tight-fitting,viselike
lost.a.03	cursed,damned,destroyed,doomed,lost,ruined,unredeemed,unsaved	blessed,ransomed,reclaimed,redeemed,rescued,salvageable,saved
loud.a.01	big,blaring,blasting,clarion,deafening,earsplitting,earthshaking,loud,loud-mouthed,shattering,shouted,thunderous,vocal,yelled	dull,euphonious,gentle,hushed,little,low,muffled,murmuring,muted,quiet,rustling,small,soft,soft-spoken,softened,subdued,whispering
piano.a.01	pianissimo,piano,soft	forte,fortissimo,loud
lovable.a.01	adorable,angelic,cherubic,cuddly,endearing,lovable,loveable,lovely,seraphic,sweet	abominable,detestable,execrable,hateful,odious,unlovable
liked.a.01	likable,likeable,liked	dislikable,disliked,unlikable,unlikeable
loved.a.01	admired,adored,beloved,best-loved,blue-eyed,cherished,darling,dear,fair-haired,favored,favorite,favourite,idolised,idolized,loved,pet,precious,preferred,treasured,wanted,white-haired,worshipped	alienated,bereft,despised,detested,disinherited,estranged,hated,jilted,loveless,lovelorn,rejected,scorned,spurned,unloved
loving.a.01	adoring,affectionate,amatory,amorous,attached,captivated,charmed,doting,enamored,fond,idolatrous,infatuated,loverly,loving,potty,romantic,smitten,tender,tenderhearted,warm	cold,detached,frigid,loveless,uncaring,unloving,unromantic
lowercase.a.01	little,lowercase,minuscule,small	capital,great,majuscule,uppercase
lucky.a.02	apotropaic,hot,lucky,serendipitous	hexed,jinxed,luckless,unlucky
major.a.01	leading,major,prima,star,starring,stellar	insignificant,minor,peanut,secondary
manageable.a.01	controllable,directed,dirigible,governable,manageable,steerable	difficult,uncontrollable,ungovernable,unmanageable,unruly
male.a.01	male,phallic,priapic,staminate	androgynous,bisexual,epicene,female,hermaphrodite,hermaphroditic,intersexual,pistillate,unisex
androgynous.a.02	androgynous,bisexual,epicene,hermaphrodite,hermaphroditic,intersexual,unisex	female,male,phallic,pistillate,priapic,staminate
married.a.01	joined,married,mated,ringed,united,wed,wedded	divorced,single,unmarried,unwed,unwedded,widowed
masculine.a.02	butch,macho,male,manly,mannish,masculine,virile	distaff,fair,female,feminine
womanly.a.01	feminine,matronly,womanly	mannish,tomboyish,unfeminine
matched.a.02	co-ordinated,coordinated,duplicate,matched,matching,mated,one-to-one,paired,twin,twinned	incompatible,mismatched,odd,unmatched,unmated,unpaired,unsuited
mature.a.03	abloom,adult,big,fruiting,full-blown,full-grown,grown,grownup,headed,marriageable,mature,matured,meridian,nubile,overblown,prime	adolescent,embryonal,embryonic,immature,inchoative,larval,prepubescent,pubescent,pupal,underdeveloped
mature.a.01	autumnal,mature,mellow,mellowed,ripe	adolescent,babyish,childish,immature,infantile,jejune,juvenile,puerile
ripe.a.01	aged,mature,mellow,mellowed,overripe,ripe,ripened	green,immature,unaged,unripe,unripened
maximal.a.01	maximal,maximum,supreme	borderline,marginal,minimal,minimum,negligible,nominal,stripped,stripped-down,token
meaningful.a.01	meaning,meaningful,meaty,pregnant,purposeful,significant,substantive	empty,hollow,insignificant,meaningless,mindless,nonsense,nonsensical,vacuous
mild.a.01	gentle,mild,mild-mannered,moderate,soft,temperate	aggravated,bad,big,brutal,cold,concentrated,consuming,deep,exquisite,extreme,fierce,intense,intensified,intensive,keen,main,overwhelming,profound,raging,screaming,severe,smart,strong,tearing,terrible,terrific,thick,trigger-happy,unabated,unrelenting,utmost,uttermost,vehement,violent,wicked,wild
military.a.03	combatant,expeditionary,martial,military,noncombatant	civil,civilian,noncombatant
mitigated.a.01	alleviated,eased,lessened,mitigated,quenched,relieved,satisfied,slaked	arrant,bally,blinking,bloody,blooming,bodacious,complete,consummate,crashing,everlasting,flaming,fucking,gross,perfect,pure,staring,stark,thoroughgoing,unadulterated,undiminished,unmitigated,unrelieved,utter
mobile.a.02	airborne,ambulant,ambulatory,floating,maneuverable,manoeuvrable,mechanised,mechanized,mobile,motile,motorized,movable,moveable,racy,rangy,rotatable,seaborne,transferable,transferrable,transplantable,transportable,versatile,waterborne	immobile,immovable,immoveable,nonmotile,stabile,stiff,unmovable
metallic.a.01	all-metal,bimetallic,bronze,gilded,gold,gold-bearing,golden,metal,metallic,silver,tinny	metalloid,nonmetal,nonmetallic
moderate.a.01	average,cautious,conservative,fair,indifferent,intermediate,limited,medium,middle-of-the-road,minimalist,moderate,modest,reasonable,small	abnormal,exaggerated,excessive,exorbitant,extortionate,extraordinary,extreme,extremist,far,immoderate,inordinate,outrageous,over-the-top,overdone,overstated,radical,sinful,stark,steep,ultra,unconscionable,undue,unreasonable,usurious
modern.a.01	contemporary,modern,modern-day,moderne,neo,red-brick,redbrick,ultramodern	antebellum,gothic,mediaeval,medieval,old-world
modest.a.01	modest,retiring,unassuming	immodest,important,overweening,uppity
moral.a.01	chaste,clean,incorrupt,moral,moralistic,righteous	debauched,degenerate,degraded,disgraceful,dissipated,dissolute,fast,immoral,libertine,profligate,riotous,scandalous,shameful,shocking
much.a.01	much,overmuch,some,such,untold	little,slight,small
motivated.a.01	actuated,driven,impelled,motivated	motiveless,unmotivated,unprovoked,wanton
moved.a.01	affected,moved,sick,stirred,touched	unaffected,unmoved,untouched
moving.a.01	afoot,automotive,blown,flaring,flying,kinetic,mobile,moving,oncoming,restless,self-propelled,vibratory,wiggly,wriggling,writhing	becalmed,fixed,frozen,inactive,inert,motionless,rigid,rooted,set,sitting,static,stationary,still,unmoving
continental.a.04	continent-wide,continental,transcontinental	intercontinental,world-wide,worldwide
national.a.02	national,nationalist,nationalistic	global,international,internationalist,multinational,planetary,supranational,transnational,world,world-wide,worldwide
natural.a.02	natural,unbleached,uncolored,undyed	arranged,artificial,bionic,bleached,cardboard,celluloid,colored,coloured,conventionalized,dummy,dyed,ersatz,factitious,fake,false,faux,imitation,man-made,near,painted,semisynthetic,simulated,staged,stylised,stylized,substitute,synthetic,unreal
necessary.a.01	essential,incumbent,indispensable,necessary,needed,needful,obligatory,required,requisite	excess,extra,gratuitous,inessential,needless,redundant,spare,superfluous,supernumerary,surplus,unnecessary,unneeded
nice.a.01	good,nice,pleasant	awful,dirty,filthy,grotty,hateful,lousy,mean,nasty
noble.a.03	dignifying,elevated,ennobling,exalted,grand,high-minded,idealistic,lofty,magnanimous,noble,rarefied,rarified,sublime	base,ignoble,mean
noble.a.02	aristocratic,august,blue,gentle,grand,highborn,imperial,kingly,lordly,majestic,monarchical,noble,patrician,princely,purple,queenly,regal,royal,titled	base,common,humble,ignoble,lowly,plebeian,untitled,unwashed,vulgar
normal.a.01	average,mean,median,modal,natural,normal,regular,typical	aberrant,abnormal,anomalous,atypical,defective,deviant,deviate,freakish,irregular,kinky,perverted,subnormal,supernormal,unnatural,vicarious
north.a.01	north,north-central,northbound,northeast,northeasterly,northeastern,northeastward,northerly,northern,northernmost,northmost,northward,northwest,northwesterly,northwestern,northwestward	south,south-central,southbound,southeast,southeasterly,southeastern,southeastward,southerly,southern,southernmost,southmost,southward,southwest,southwesterly,southwestern,southwestward
northern.a.04	boreal,circumboreal,north-central,northern	austral,meridional,south-central,southern
detected.a.01	detected,heard,perceived,sensed	undetected,undiscovered,unobserved,unseen
obedient.a.01	acquiescent,conformable,dutiful,obedient	contrary,disobedient,fractious,headstrong,obstinate,perverse,recalcitrant,recusant,refractory,wayward,wilful,willful
objective.a.01	clinical,impersonal,neutral,objective,verifiable	personal,prejudiced,subjective,unobjective,unverifiable
obstructed.a.01	barred,barricaded,blockaded,blocked,choked,clogged,deadlocked,impeded,obstructed,occluded,plugged,stalemated,stopped,stuffy	clear,open,patent,unclogged,unimpeded,unobstructed
occupied.a.01	busy,engaged,filled,occupied	free,spare,unoccupied
offensive.a.05	abhorrent,charnel,creepy,detestable,disgusting,distasteful,foul,ghastly,ghoulish,hideous,horrid,horrific,loathsome,morbid,objectionable,obnoxious,obscene,offensive,outrageous,rank,repellant,repellent,repelling,repugnant,repulsive,revolting,sepulchral,skanky,wicked,yucky	innocuous,inoffensive,unobjectionable
offensive.a.02	antipersonnel,assaultive,attacking,hit-and-run,invading,invasive,marauding,offensive,predatory,raiding	antiaircraft,antisubmarine,antitank,defending,defensive
official.a.01	authorised,authoritative,authorized,formal,formalised,formalized,official,semiofficial	drumhead,informal,loose,summary,unauthorised,unauthorized,unofficial,unsanctioned,wildcat
established.a.01	constituted,deep-rooted,deep-seated,entrenched,established,grooved,implanted,ingrained,legitimate,official,planted,recognised,recognized	unestablished,unrecognised,unrecognized
old.a.02	age-old,antediluvian,antiquated,antique,archaic,auld,hand-me-down,hoary,immemorial,long-ago,longtime,old,patched,rusty,secondhand,sunset,used,yellow,yellowed	brand-new,fresh,hot,new,newborn,newfound,novel,parvenu,radical,recent,red-hot,refreshing,revolutionary,rising,sunrise,untested,untried,unused,virgin,young
old.a.01	aged,ageing,aging,ancient,centenarian,darkened,doddering,elderly,emeritus,gaga,gray,grey,grey-haired,grey-headed,grizzly,hoar,hoary,middle-aged,nonagenarian,octogenarian,old,older,overage,senescent,senile,senior,sexagenarian,superannuated,venerable,white-haired	adolescent,boyish,childlike,early,five-year-old,four-year-old,girlish,immature,infantile,junior,little,newborn,one-year-old,preadolescent,preteen,puppyish,small,teen,teenage,teenaged,tender,three-year-old,two-year-old,vernal,young,youngish,youthful
open.a.02	open,opened,yawning	blocked,closed,drawn,stoppered
open.a.05	agape,gaping,open,opened,staring,wide,wide-eyed,yawning	blinking,closed,compressed,shut,squinting,tight,winking
enclosed.a.01	besieged,boxed,clathrate,closed,embedded,encircled,enclosed,included,involved,surrounded	open,unenclosed,unfenced
opportune.a.01	good,opportune,right,ripe,seasonable,timely,well-timed	ill-timed,inconvenient,inopportune,unseasonable,untimely,wrong
optimistic.a.01	bullish,cheerful,optimistic,pollyannaish,rose-colored,rosy,sanguine,upbeat	bearish,demoralised,demoralized,discouraged,disheartened,pessimistic
organized.a.01	arranged,configured,corporate,incorporated,organized,re-formed,reorganised,reorganized	uncoordinated,unformed,unincorporated,unorganised,unorganized
ordinary.a.01	average,characterless,common,commonplace,everyday,fair,indifferent,mediocre,middling,mundane,nondescript,ordinary,quotidian,routine,run-of-the-mill,so-so,unexceptional,unremarkable,workaday	awful,exceeding,exceptional,extraordinaire,extraordinary,fantastic,frightful,grand,great,howling,marvellous,marvelous,olympian,one,phenomenal,preternatural,prodigious,pyrotechnic,rare,rattling,remarkable,singular,some,special,surpassing,terrible,terrific,tremendous,uncanny,uncommon,wonderful,wondrous
organic.a.02	integrated,organic,structured	amorphous,artificial,inorganic,mineral,unstructured
oriented.a.01	adjusted,bound,destined,directed,familiarised,familiarized,headed,homeward,homeward-bound,minded,orientated,oriented	alienated,anomic,confused,disoriented,lost
orienting.a.01	aligning,dimensioning,familiarising,familiarizing,homing,orienting,positioning	confusing,disorienting,estranging,stunning,stupefying
original.a.03	avant-garde,daring,freehand,fresh,germinal,groundbreaking,innovative,new,newfangled,novel,original,seminal	banal,cliched,cold,commonplace,corny,dusty,hackneyed,platitudinous,ready-made,shopworn,slavish,stale,stock,threadbare,timeworn,tired,trite,unoriginal,well-worn
orthodox.a.02	canonic,canonical,conforming,conformist,conventional,established,orthodox,sanctioned,traditional,unreformed	dissident,heretical,heterodox,iconoclastic,nonconforming,nonconformist,recusant,unorthodox
covered.a.01	beaded,blanketed,canopied,cloaked,clothed,covered,crusted,crusty,dabbled,draped,drenched,dusty,encrusted,mantled,mossy,muffled,overgrown,plastered,sealed,smothered,snow-covered,snowy,spattered,splashed,splashy,splattered,tiled,white,wrapped	bald,bare,denuded,naked,unroofed
leafy.a.01	bowery,foliate,leaf-like,leafed,leaflike,leafy,leaved,petal-like	defoliate,defoliated,leafless
overt.a.01	bald,barefaced,naked,open,overt,raw,undisguised,visible	backstairs,behind-the-scenes,black,clandestine,cloaked,collusive,conniving,covert,disguised,furtive,masked,secret,subterranean,surreptitious,ulterior,undercover,underground,undisclosed,unrevealed
paid.a.01	cashed,compensable,compensated,free-lance,freelance,mercenary,paid,paid-up,paying,postpaid,prepaid,remunerated,remunerative,salaried,square,stipendiary	complimentary,costless,free,gratis,gratuitous,non-paying,outstanding,owing,rent-free,uncompensated,unpaid,unsalaried
painted.a.01	finished,painted,stained,varnished,whitewashed	bare,unfinished,unpainted,unstained,unvarnished
parallel.a.01	antiparallel,collateral,parallel	bias,diagonal,normal,oblique,orthogonal,perpendicular,rectangular,right,sideways
oblique.a.01	bias,diagonal,oblique,sideways	antiparallel,collateral,normal,orthogonal,parallel,perpendicular,rectangular,right
perpendicular.a.01	normal,orthogonal,perpendicular,rectangular,right	antiparallel,bias,collateral,diagonal,oblique,parallel,sideways
pardonable.a.01	excusable,forgivable,minor,pardonable,venial	deadly,inexcusable,mortal,unforgivable,unpardonable
partial.a.02	biased,colored,coloured,one-sided,partial,slanted	disinterested,dispassionate,impartial,indifferent,unbiased
passable.a.01	climbable,navigable,negotiable,passable,surmountable,traversable	impassable,unnavigable,unpassable,unsurmountable
past.a.01	ago,agone,ancient,bygone,chivalric,departed,early,erstwhile,foregone,former,gone,historic,historical,knightly,last,late,medieval,old,olden,one-time,onetime,other,past,prehistoric,prehistorical,previous,quondam,recent,sometime,then,ult,ultimo	approaching,coming,early,emerging,existing,forthcoming,future,immediate,inst,instant,latter-day,present,prox,proximo,rising,upcoming
present.a.01	existing,immediate,inst,instant,latter-day,present	ago,agone,ancient,approaching,bygone,chivalric,coming,departed,early,emerging,erstwhile,foregone,former,forthcoming,future,gone,historic,historical,knightly,last,late,medieval,old,olden,one-time,onetime,other,past,prehistoric,prehistorical,previous,prox,proximo,quondam,recent,rising,sometime,then,ult,ultimo,upcoming
future.a.01	approaching,coming,early,emerging,forthcoming,future,prox,proximo,rising,upcoming	ago,agone,ancient,bygone,chivalric,departed,early,erstwhile,existing,foregone,former,gone,historic,historical,immediate,inst,instant,knightly,last,late,latter-day,medieval,old,olden,one-time,onetime,other,past,prehistoric,prehistorical,present,previous,quondam,recent,sometime,then,ult,ultimo
peaceful.a.01	dovish,halcyon,pacific,pacifist,pacifistic,peace-loving,peaceable,peaceful	belligerent,hawkish,militant,stormy,tempestuous,warlike,warring
perceptive.a.02	acute,apprehensive,discerning,discriminating,incisive,insightful,keen,knifelike,observant,observing,penetrating,penetrative,perceptive,piercing,sharp,subtle,understanding	blind,unobservant,unseeing
perceptible.a.01	detectable,discernible,faint,noticeable,palpable,perceivable,perceptible,recognizable,sensible,weak	imperceptible,indiscernible,insensible,subliminal,undetectable,unobservable
perfect.a.01	clean,clear,cold,complete,consummate,down,errorless,faultless,flawless,ideal,idealised,idealized,idyllic,immaculate,impeccable,mastered,mint,perfect,pluperfect,uncorrupted,undefiled	blemished,broken,corrupt,corrupted,defective,faulty,flawed,imperfect,irregular
permanent.a.01	abiding,ageless,enduring,eternal,everlasting,imperishable,indissoluble,lasting,permanent,perpetual,standing,unceasing,unending	acting,ephemeral,episodic,evanescent,impermanent,improvised,interim,jury-rigged,makeshift,passing,shipboard,short-lived,temporal,temporary,transient,transitory,working
persuasive.a.01	coaxing,cogent,compelling,glib,persuasive,telling,weighty	admonitory,cautionary,discouraging,dissuasive,exemplary,monitory,warning
permeable.a.01	permeable,porous,semipermeable	impermeable,retentive,water-resistant
physical.a.01	animal,bodily,carnal,corporal,corporeal,fleshly,material,personal,physical,physiologic,physiological,sensual,somatic	intellectual,mental,moral,noetic,psychic,psychical,psychogenic,psychological,rational
pious.a.01	devotional,godly,pharisaic,pietistic,pious,prayerful,reverent,sanctimonious,self-righteous,worshipful	godless,impious,irreverent
religious.a.02	churchgoing,churchly,devout,god-fearing,interfaith,religious	atheistic,ethnic,heathen,irreligious,lapsed,nonobservant,pagan,unbelieving
plain.a.02	austere,bare,chaste,dry,featureless,homely,literal,mere,plain,severe,simple,stark,stern,tailored,trim,vanilla	baroque,battlemented,busy,castellated,castled,churrigueresque,crackle,damascene,damask,dressy,elaborate,embattled,fanciful,fancy,fantastic,flamboyant,florid,fussy,lacy,luxuriant,puff,puffed,rococo
planned.a.01	contrived,planned,predetermined,preset	casual,chance,unplanned,unpremeditated
plausible.a.01	arguable,glib,pat,plausible,slick	implausible,improbable,unbelievable,unconvincing,unlikely
pleasant.a.01	beautiful,dulcet,enjoyable,grateful,gratifying,idyllic,pleasant,pleasurable	acerbic,acid,acrid,beastly,bitter,blistering,caustic,dour,dreadful,embarrassing,forbidding,grim,harsh,hellish,hot,mortifying,painful,repellant,repellent,rough,sharp,sore,sulfurous,sulphurous,tart,ungrateful,unhappy,unpleasant,virulent,vitriolic
pleased.a.01	amused,chuffed,delighted,diverted,encouraged,entertained,gratified,pleased	annoyed,disgusted,displeased,exasperated,frowning,irritated,miffed,nettled,offended,pained,peeved,pissed,riled,roiled,sick,steamed,stung
pleasing.a.01	admirable,charming,delicious,delightful,easy,fab,fabulous,good,gratifying,ingratiating,pleasing,sweet	disconcerting,displeasing,exasperating,infuriating,maddening,off-putting,upsetting,vexing
polished.a.01	bright,burnished,finished,lustrous,polished,shining,shiny	raw,rough,unpolished
politic.a.01	expedient,politic,sagacious	impolitic,inexpedient,unwise
political.a.01	governmental,policy-making,political	apolitical,nonpolitical,unpolitical
positive.a.01	affirmative,constructive,optimistic,positive	antagonistic,counter,negative,neutral,neutralised,neutralized,perverse
negative.a.01	antagonistic,counter,negative,perverse	affirmative,constructive,neutral,neutralised,neutralized,optimistic,positive
neutral.a.04	neutral,neutralised,neutralized	affirmative,antagonistic,constructive,counter,negative,optimistic,perverse,positive
possible.a.01	achievable,attainable,contingent,doable,executable,feasible,manageable,mathematical,possible,practicable,realizable,viable,workable	hopeless,impossible,impracticable,infeasible,out,unachievable,unattainable,undoable,unfeasible,unrealizable,unworkable
potent.a.03	multipotent,potent,stiff,strong	impotent,ineffective,ineffectual,unable
powerful.a.01	all-powerful,almighty,coercive,compelling,mighty,muscular,omnipotent,potent,powerful,puissant,regent,regnant,reigning,ruling,strong	feeble,helpless,incapacitated,low-powered,nerveless,powerless,weak
plowed.a.01	ploughed,plowed,tilled	fallow,unbroken,unplowed,untilled
practical.a.01	applicative,functional,interoperable,matter-of-fact,operable,practicable,practical,pragmatic,serviceable,unimaginative,working	crazy,half-baked,impractical,quixotic,romantic,screwball,unwieldy,wild-eyed
predictable.a.01	foreseeable,inevitable,predictable	aleatory,capricious,episodic,freakish,occasional,unforeseeable,unpredictable
prepared.a.01	braced,embattled,equipped,preconditioned,precooked,prepared,processed,ready,spread,up	ad-lib,extemporaneous,extempore,impromptu,off-the-cuff,offhand,offhanded,unprepared,unrehearsed
present.a.02	attendant,ever-present,existing,here,omnipresent,present,ubiquitous	absent,away,awol,truant
ostentatious.a.01	flamboyant,ostentatious,pretentious,showy,splashy	quiet,restrained,unostentatious,unpretentious
pretentious.a.01	arty,grandiloquent,grandiose,highfalutin,inflated,overblown,parvenu,pompous,pontifical,portentous,pretentious,sententious,upstart	honest,modest,unpretentious
primary.a.01	capital,direct,first-string,firsthand,original,particular,primary,special	alternate,alternative,auxiliary,collateral,indirect,second-string,secondary,secondhand,standby,subsidiary,substitute,supplemental,supplementary,tributary,utility,vicarious
basic.a.01	basal,base,basic,elemental,elementary,fundamental,grassroots,primary,radical,rudimentary,underlying	incident,incidental,parenthetical,peripheral,secondary
private.a.01	backstage,clannish,cliquish,cloistered,close,closed-door,clubby,confidential,head-to-head,insular,nonpublic,offstage,one-on-one,private,privy,reclusive,secluded,secret,semiprivate,sequestered,snobbish,snobby	national,open,public,semipublic,state-supported,unrestricted
productive.a.01	arable,cultivable,cultivatable,fecund,fertile,fur-bearing,oil-bearing,productive,prolific,rich,tillable	dry,fruitless,futile,nonproductive,sleeveless,unproductive,vain
professional.a.01	paid,professed,professional	amateur,lay,nonprofessional,recreational,unpaid
profitable.a.01	bankable,economic,fat,gainful,juicy,lucrative,moneymaking,paid,paying,profitable,remunerative	dead,idle,lean,marginal,unprofitable
profound.a.01	deep,profound,thoughtful	apparent,dilettante,facile,glib,looking,ostensible,seeming,shallow,sounding,superficial
progressive.a.01	advanced,advancing,forward,forward-looking,innovative,modern,modernised,modernized,progressive,state-of-the-art	atavistic,regressive,retrograde,retrogressive,returning,reverting,throwback
proper.a.01	becoming,comely,correct,decent,decorous,fitting,halal,kosher,priggish,prim,prissy,proper,prudish,puritanical,right,seemly,straight-laced,strait-laced,straitlaced,victorian	improper,incorrect,indecent,indecorous,out-of-the-way,unbecoming,unseemly,untoward,wrong
prospective.a.01	future,likely,potential,prospective	retro,retroactive,retrospective
protected.a.01	bastioned,battlemented,covert,fortified,moated,protected,shielded,snug,weatherproof	defenseless,exposed,naked,open,unprotected,unshielded
proud.a.01	arrogant,beaming,big,boastful,braggart,bragging,chesty,conceited,crowing,dignified,disdainful,egotistic,egotistical,haughty,imperious,lordly,overbearing,persnickety,pleased,prideful,proud,self-aggrandizing,self-important,self-respecting,sniffy,snooty,snotty,stuck-up,supercilious,swaggering,swelled,swollen,uppish,vain,vainglorious	broken,crushed,humble,humbled,humiliated,low,meek,mild,modest
proved.a.01	established,evidenced,proved,proven,tested,tried,verified	unproved,unproven,unverified
provident.a.01	careful,farsighted,foresighted,long,provident,thrifty	improvident,myopic,short,shortsighted
prudent.a.01	circumspect,discreet,heady,judicious,provident,prudent,prudential,wise	ill-considered,improvident,imprudent,injudicious,rash,shortsighted
punctual.a.01	prompt,punctual,timely	belated,benighted,last-minute,late,tardy
purebred.a.01	blooded,full-blood,full-blooded,pedigree,pedigreed,pureblood,purebred,thoroughbred	crossbred,half-breed,hybrid
pure.a.01	clean,clear,fine,fresh,light,native,plain,pristine,pure,sheer,sublimate,unadulterated,unalloyed,unclouded,uncontaminated,unmixed,unpolluted,virginal	adulterate,adulterated,alloyed,bastardized,contaminated,debased,dingy,dirty,impure,muddied,muddy,polluted
purposeful.a.01	businesslike,earnest,goal-directed,purpose-built,purpose-made,purposeful,purposive	adrift,afloat,aimless,desultory,directionless,purposeless,rudderless,undirected
trained.a.01	disciplined,drilled,housebroken,trained	naive,primitive,undisciplined,untrained
qualified.a.02	conditional,hedged,limited,modified,qualified	categoric,categorical,clean,clear,cool,flat,outright,unconditional,unlimited,unqualified
questionable.a.01	alleged,apocryphal,debatable,doubtful,dubious,equivocal,fishy,funny,problematic,problematical,questionable,self-styled,shady,so-called,supposed,suspect,suspicious	acknowledged,indubitable,mathematical,unimpeachable,unquestionable
quiet.a.02	noiseless,quiet,silent,soundless,still,tiptoe	abuzz,blatant,buzzing,clamorous,clanging,clangorous,clanking,creaky,noisy,reedy,strident,swishy,thundering,uproarious,vociferous,wheezy,whirring
quiet.a.01	quiescent,quiet,untroubled	disruptive,riotous,squalling,squally,troubled,tumultuous,turbulent,unquiet
rational.a.01	coherent,intelligent,logical,lucid,rational,reasonable,reasoning,sane,thinking	blind,irrational,nonrational,superstitious,unreasoning
reactive.a.01	activated,excited,labile,reactive,unstable	inactive,indifferent,inert,neutral,noble,stable,unreactive
ready.a.01	fit,primed,prompt,ready,ripe,set,waiting	flat-footed,napping,off-guard,unready,unripe
real.a.01	actual,documentary,existent,factual,historical,objective,real	dreamed,envisioned,fabled,fabricated,fabulous,fancied,fanciful,fantastic,fantastical,fictional,fictitious,hallucinatory,illusionary,illusive,illusory,imaginary,legendary,make-believe,mythic,mythical,mythological,notional,pictured,pretend,unreal,visualised,visualized
real.a.02	proper,real,true	deceptive,dreamlike,phantom,surreal,unreal
realistic.a.01	down-to-earth,earthy,graphic,hard-nosed,hardheaded,lifelike,living,pictorial,practical,pragmatic,real,realistic,true-to-life,veridical,virtual,vivid	chimerical,false,fantastic,kafkaesque,phantasmagoric,phantasmagorical,surreal,surrealistic,unrealistic,wild
reasonable.a.01	commonsense,commonsensical,healthy,intelligent,level-headed,levelheaded,reasonable,sensible,sound,tenable,well-founded	counterintuitive,indefensible,mindless,senseless,undue,unjustified,unreasonable,untenable,unwarranted
reciprocal.a.01	bilateral,correlative,interactional,interactive,mutual,reciprocal,trilateral	unanswered,unreciprocated,unrequited
refined.a.01	civilised,civilized,couth,cultivated,cultured,dainty,debonair,delicate,genteel,gentlemanly,ladylike,mincing,patrician,polite,prim,refined,suave,superfine,twee,well-bred,well-mannered	agrestic,artless,boorish,coarse,common,crass,loutish,low,neanderthal,oafish,robust,rough,rough-cut,rude,swinish,uncouth,uncultivated,uncultured,ungentlemanly,unladylike,unrefined,vulgar
processed.a.03	cured,milled,polished,processed,vulcanized	natural,raw,rude,streaming,unprocessed
recoverable.a.01	recoverable,redeemable,retrievable	irrecoverable,irretrievable,lost,unrecoverable
regenerate.a.01	born-again,converted,reborn,reformed,regenerate	cussed,obdurate,obstinate,unconverted,unpersuaded,unregenerate,unrepentant
regular.a.01	first-string,lawful,official,prescribed,regular,standard,stock,timed,uniform,weak,well-ordered	asymmetrical,casual,crooked,improper,irregular,occasional,randomised,randomized,strong,unconventional,unlawful
uniform.a.01	single,uniform,unvarying	multiform,polymorphic,polymorphous
related.a.01	affiliated,age-related,attached,cognate,connate,connected,correlate,correlated,correlative,corresponding,related	orthogonal,uncorrelated,unrelated
relevant.a.01	applicable,germane,pertinent,relevant	digressive,extraneous,immaterial,impertinent,inapplicable,irrelevant,moot,orthogonal,tangential,unsuitable
mindful.a.01	aware,careful,evocative,mindful,redolent,reminiscent,resonant	amnesiac,amnesic,forgetful,mindless,unmindful
representational.a.01	eidetic,figural,figurative,mimetic,naturalistic,realistic,representational	abstract,abstractionist,conventional,formal,geometric,geometrical,hieratic,nonobjective,nonrepresentational,schematic
reputable.a.01	esteemed,estimable,good,honorable,honored,prestigious,redoubtable,reputable,respectable,respected,time-honored,time-honoured	damaged,discreditable,discredited,disreputable,infamous,louche,notorious,seamy,seedy,shady,sleazy,sordid,squalid
receptive.a.02	assimilative,hospitable,open,receptive	closed,unreceptive,unsympathetic
resolute.a.01	bent,desperate,determined,do-or-die,firm,foursquare,hell-bent,resolute,resolved,single-minded,spartan,stalwart,steadfast,steady,stiff,stout,undaunted,undeterred,unfaltering,unshakable,unshaken,unwavering	discouraged,infirm,irresolute,unstable,vacillating,wavering
respectful.a.01	deferent,deferential,honorific,respectful	annihilating,contemptuous,derisive,devastating,disdainful,disrespectful,flip,impious,impudent,insolent,insulting,jeering,mocking,scornful,taunting,withering
responsible.a.01	accountable,amenable,answerable,liable,responsible,trustworthy	carefree,devil-may-care,do-nothing,feckless,freewheeling,happy-go-lucky,idle,irresponsible,loose,trigger-happy,unaccountable,unreliable
restrained.a.02	close,low-key,restrained,subdued	excessive,extravagant,exuberant,freewheeling,highflying,overweening,unbridled,unbuttoned,unchecked,ungoverned,unhampered,unhindered,unlaced,unrestrained
restricted.a.01	circumscribed,closed,limited,off-limits,out-of-bounds,restricted	all-weather,discretionary,open,open-ended,open-plan,unrestricted
reverberant.a.01	bright,brilliant,clinking,echoing,hollow,jingling,live,resonant,resonating,resounding,reverberant,reverberating,tinkling,tinkly,vibrant	anechoic,dead,dull,thudding
reverent.a.01	adoring,awed,awful,respectful,reverent,reverential,venerating,worshipful	blasphemous,disrespectful,irreverent,profane,sacrilegious
rhetorical.a.02	bombastic,declamatory,flowery,forensic,grandiloquent,large,oratorical,ornate,poetic,poetical,purple,rhetorical,stylistic,tall,turgid	matter-of-fact,plainspoken,prosaic
rich.a.01	affluent,comfortable,easy,flush,loaded,moneyed,prosperous,rich,wealthy,well-heeled,well-off,well-to-do	broke,bust,destitute,impecunious,impoverished,indigent,moneyless,needy,penniless,penurious,pinched,poor,poverty-stricken,skint
right-handed.a.01	dextral,right,right-hand,right-handed	ambidextrous,left,left-hand,left-handed,sinistral,two-handed
left-handed.a.01	left,left-hand,left-handed,sinistral	ambidextrous,dextral,right,right-hand,right-handed,two-handed
right.a.07	conservative,far-right,old-line,reactionary,right,right-wing,rightist	center,centrist,left,left-of-center,left-wing,leftish,leftist,liberal,middle-of-the-road
left.a.04	left,left-of-center,left-wing,leftish,leftist,liberal	center,centrist,conservative,far-right,middle-of-the-road,old-line,reactionary,right,right-wing,rightist
center.a.02	center,centrist,middle-of-the-road	conservative,far-right,left,left-of-center,left-wing,leftish,leftist,liberal,old-line,reactionary,right,right-wing,rightist
right.a.01	far,right,right-hand,rightmost,starboard	left,left-hand,leftmost,near,nigh,port
right.a.04	ethical,honorable,honourable,right	base,condemnable,criminal,deplorable,immoral,misguided,mistaken,reprehensible,vicious,wrong
righteous.a.01	good,just,righteous,sound,upright	sinful,unholy,unrighteous,wicked
robust.a.01	beefy,broad-shouldered,burly,cast-iron,chesty,hardy,husky,iron,robust,stalwart,stout,strapping,sturdy,vigorous	decrepit,feeble,frail,infirm,rickety,weak,weakly
round.a.01	ball-shaped,barrel-shaped,bulbous,capitate,circular,coccoid,disc-shaped,discoid,discoidal,disk-shaped,global,globose,globular,moonlike,orbicular,pear-shaped,round,roundish,spherical	quadrate,right-angled,square,squared,squarish
rounded.a.01	almond-shaped,annular,aspheric,aspherical,crescent,crescent-shaped,cycloid,cycloidal,cylindric,cylindrical,dome-shaped,domed,egg-shaped,ellipsoid,ellipsoidal,elliptic,elliptical,lunate,oval,oval-shaped,ovate,ovoid,parabolic,pineal,prolate,ring-shaped,ringed,rod-shaped,rotund,rounded,semilunar,spheroidal,terete,vaulted	angled,angular,asteroid,bicuspid,cusped,equiangular,rectangular,square-shaped,star-shaped,three-cornered,triangular,tricuspid
rural.a.01	agrarian,agrestic,agricultural,arcadian,bucolic,countrified,country-style,farming,folksy,homespun,pastoral,rural,rustic	citified,urban,urbanised,urbanized
holy.a.01	beatified,blessed,consecrated,hallowed,holy,sacred,sanctified	profane,unconsecrated,unholy
sacred.a.01	divine,ineffable,inspirational,inviolable,inviolate,numinous,quasi-religious,religious,reverend,sacral,sacred,sacrosanct,spiritual,sublime,taboo,tabu,unnameable,unspeakable,unutterable	lay,profane,secular
safe.a.01	fail-safe,risk-free,riskless,safe,unhurt	breakneck,chancy,dangerous,desperate,dicey,dodgy,hazardous,insidious,parlous,perilous,precarious,risky,self-destructive,suicidal,touch-and-go,treacherous,unreliable,unsafe,wild
salable.a.01	marketable,salable,saleable,sellable	unmarketable,unsalable,unsaleable
same.a.02	comparable,cookie-cutter,corresponding,duplicate,homophonic,identical,indistinguishable,like,one,same,synoptic	antithetical,assorted,contrary,contrasting,contrastive,diametric,diametrical,different,disparate,distinct,distinguishable,divergent,divers,diverse,opposite,polar,several,variant,various
same.a.01	aforementioned,aforesaid,identical,said,same,selfsame,very	another,different,new,opposite,other,otherwise
satiate.a.01	jaded,satiate,satiated,satisfiable	insatiable,unquenchable,unsatisfiable,unsatisfied
satisfactory.a.01	adequate,alright,cheering,comforting,copacetic,fine,ok,okay,passable,passing,right,satisfactory,satisfying,tolerable	disappointing,failing,off,unacceptable,unsatisfactory,unsatisfying
concealed.a.02	bushwhacking,concealed,dark,furtive,hidden,incognito,obscure,sealed,secret,sneak,sneaking,sneaky,stealthy,surreptitious	blatant,blazing,conspicuous,exhibitionistic,unconcealed
sectarian.a.02	denominational,narrow-minded,sectarian	ecumenical,interchurch,interdenominational,nondenominational,nonsectarian
secure.a.02	assured,fail-safe,firm,secure,sure	insecure,precarious,shaky,unguaranteed,unsafe,unsecured
selfish.a.01	egotistic,egotistical,narcissistic,self-serving,selfish	public-spirited,self-denying,self-sacrificing,sharing,unselfish
senior.a.01	elder,higher-ranking,major,older,precedential,ranking,senior,superior	junior,lower-ranking,lowly,minor,petty,secondary,subaltern,younger
sensitive.a.01	delicate,erogenous,excitable,irritable,light-sensitive,nociceptive,photosensitive,reactive,responsive,sensitive	dead,deadened,insensitive,unreactive
sensitive.a.02	alive,feisty,huffy,oversensitive,sensitive,thin-skinned,touchy	callous,dead,dull,insensible,insensitive,numb,soulless,thick-skinned,unaffected
separate.a.01	apart,asunder,detached,discrete,disjoint,disjunct,distinct,isolated,separate,separated,unaccompanied	clannish,collective,concerted,conjoined,conjoint,conjunct,conjunctive,cooperative,corporate,joint
sanitary.a.01	healthful,hygienic,sanitary	insanitary,unhealthful,unhygienic,unsanitary
septic.a.01	abscessed,dirty,infected,infectious,infective,purulent,pussy,septic	antiseptic,aseptic,bactericidal,clean,cleansing,disinfectant,germicidal,purifying,sterile,uninfected
adulterating.a.01	adulterant,adulterating,extraneous,foreign	antiseptic,cleansing,detergent,purifying
serious.a.01	earnest,grave,real,sedate,serious,serious-minded,sincere,sober,sobering,solemn,solid,thoughtful	airheaded,dizzy,flighty,flippant,flyaway,frivolous,giddy,idle,light,lightheaded,scatterbrained,silly,trivial
serviceable.a.01	durable,functional,operable,operational,serviceable,usable,useable	broken-down,burned-out,burnt-out,inoperable,unrepaired,unserviceable
settled.a.02	based,built-up,located,placed,relocated,resettled,set,settled,situated	aimless,drifting,erratic,floating,homeless,itinerant,migrant,migratory,mobile,nomadic,peregrine,peripatetic,planetary,rootless,roving,stateless,unsettled,vagabond,vagrant,wandering,wayfaring
settled.a.01	accomplished,appointed,decreed,determined,deterministic,dictated,effected,established,firm,ordained,prescribed,set,settled	doubtful,open,tentative,undecided,undetermined,unresolved,unsettled
sexual.a.02	intersexual,sexed,sexual,unisexual	agamic,apomictic,asexual,neuter,nonsexual,parthenogenetic,sexless,vegetal,vegetative
shapely.a.01	bosomy,busty,buxom,curvaceous,curvy,modeled,sculptural,sculptured,shapely,stacked,statuesque,upturned,voluptuous,well-endowed,well-proportioned	chunky,deformed,distorted,knobbly,knobby,lumpy,malformed,misshapen,nodular,shapeless
formed.a.01	bacillary,club-shaped,cross-shaped,die-cast,ductile,fan-shaped,formed,funnel-shaped,hook-shaped,horn-shaped,hourglass-shaped,lance-shaped,malleable,molded,navicular,perfected,pliable,pliant,precast,rod-shaped,s-shaped,saddle-shaped,scaphoid,shaped,spoon-shaped,tensile,trumpet-shaped,v-shaped,vase-shaped,vermiform,wrought	amorphous,formless,shapeless,unformed
shared.a.01	common,joint,mutual,shared	exclusive,individual,single,sole,undivided,unshared
shaven.a.01	beardless,clean-shaven,shaved,shaven	barbate,bearded,bewhiskered,goateed,mustached,mustachioed,stubbled,stubbly,unshaved,unshaven,whiskered,whiskery
shod.a.01	booted,roughshod,sandaled,shod,shoed	barefoot,barefooted,shoeless,stockinged
significant.a.01	earthshaking,epoch-making,epochal,evidential,evidentiary,fundamental,important,large,momentous,monumental,noteworthy,operative,portentous,probative,prodigious,profound,remarkable,significant	flimsy,fragile,insignificant,light,slight,superficial,tenuous,thin,trivial,unimportant
simple.a.06	acicular,acuminate,arrow-shaped,caudate,cordate,cuneate,deltoid,elliptic,elongate,heart-shaped,kidney-shaped,lanceolate,linear,needled,oblanceolate,oblong,obovate,obtuse,orbicular,ovate,peltate,reniform,shield-shaped,simple,spatulate,unlobed,wedge-shaped	bilobed,bipartite,bipinnate,cleft,compound,conjugate,dissected,incised,lobate,lobed,palmate,parted,pinnate,radiate,ternate,three-lobed,trifoliate,tripinnate
simple.a.01	simple,simplex,simplistic,uncomplicated,unsophisticated	colonial,complex,complicated,composite,compound,convoluted,decomposable,interlacing,interlinking,interlocking,interwoven,intricate,involved,knotty,labyrinthian,labyrinthine,mazy,multifactorial,multiplex,tangled,thickening,tortuous
sincere.a.01	cordial,dear,devout,earnest,genuine,heartfelt,honest,sincere,true,unfeigned,wholehearted	buttery,false,fawning,feigned,fulsome,gilded,hypocritical,insincere,meretricious,obsequious,oily,oleaginous,plausible,smarmy,soapy,specious,sycophantic,unctuous
cardinal.a.02	0,1,10,100,1000,101,105,11,110,115,12,120,125,13,130,135,14,140,145,15,150,155,16,160,165,17,170,175,18,180,19,190,2,20,200,21,22,23,24,25,26,27,28,29,3,30,300,31,32,33,34,35,36,37,38,39,4,40,400,41,42,43,44,45,46,47,48,49,5,50,500,51,52,53,54,55,56,57,58,59,6,60,61,62,63,64,65,66,67,68,69,7,70,71,72,73,74,75,76,77,78,79,8,80,81,82,83,84,85,86,87,88,89,9,90,91,92,93,94,95,96,97,98,99,ane,billion,c,cardinal,cc,ccc,cd,ci,cl,clv,clx,cv,cx,cxl,d,dozen,eight,eighteen,eighty,eighty-eight,eighty-five,eighty-four,eighty-nine,eighty-one,eighty-seven,eighty-six,eighty-three,eighty-two,eleven,fifteen,fifty,fifty-eight,fifty-five,fifty-four,fifty-nine,fifty-one,fifty-seven,fifty-six,fifty-three,fifty-two,five,forty,forty-eight,forty-five,forty-four,forty-nine,forty-one,forty-seven,forty-six,forty-three,forty-two,four,fourteen,half-dozen,hundred,i,ic,ii,iii,il,ilx,iv,ix,ixc,ixl,k,l,li,lii,liii,liv,lv,lvi,lvii,lviii,lx,lxi,lxii,lxx,m,million,nine,nineteen,ninety,ninety-eight,ninety-five,ninety-four,ninety-nine,ninety-one,ninety-seven,ninety-six,ninety-three,ninety-two,non-zero,one,seven,seventeen,seventy,seventy-eight,seventy-five,seventy-four,seventy-nine,seventy-one,seventy-seven,seventy-six,seventy-three,seventy-two,six,sixteen,sixty,sixty-eight,sixty-five,sixty-four,sixty-nine,sixty-one,sixty-seven,sixty-six,sixty-three,sixty-two,ten,thirteen,thirty,thirty-eight,thirty-five,thirty-four,thirty-nine,thirty-one,thirty-seven,thirty-six,thirty-three,thirty-two,thousand,three,threescore,trillion,twelve,twenty,twenty-eight,twenty-five,twenty-four,twenty-nine,twenty-one,twenty-seven,twenty-six,twenty-three,twenty-two,two,v,vi,vii,viii,x,xc,xi,xii,xiii,xiv,xix,xl,xli,xlii,xliii,xliv,xlv,xlvi,xlvii,xlviii,xv,xvi,xvii,xviii,xx,xxi,xxii,xxiii,xxiv,xxix,xxv,xxvi,xxvii,xxviii,xxx,xxxi,xxxii,xxxiii,xxxiv,xxxv,xxxvi,xxxvii,xxxviii,zero,zillion	1000th,100th,101st,105th,10th,110th,115th,11th,120th,125th,12th,130th,135th,13th,140th,145th,14th,150th,155th,15th,160th,165th,16th,170th,175th,17th,180th,18th,190th,19th,1st,200th,20th,21st,22nd,23rd,24th,25th,26th,27th,28th,29th,2d,2nd,300th,30th,31st,32nd,33rd,34th,35th,36th,37th,38th,39th,3rd,400th,40th,41st,42nd,43rd,44th,45th,46th,47th,48th,49th,4th,500th,50th,55th,5th,60th,64th,65th,6th,70th,75th,7th,80th,85th,8th,90th,95th,9th,billionth,eighteenth,eighth,eightieth,eighty-fifth,eleventh,fifteenth,fifth,fiftieth,fifty-fifth,first,fortieth,forty-eighth,forty-fifth,forty-first,forty-fourth,forty-ninth,forty-second,forty-seventh,forty-sixth,forty-third,fourteenth,fourth,hundredth,millionth,nineteenth,ninetieth,ninety-fifth,ninth,nth,ordinal,quaternary,second,seventeenth,seventh,seventieth,seventy-fifth,sixteenth,sixth,sixtieth,sixty-fifth,sixty-fourth,tenth,tertiary,third,thirteenth,thirtieth,thirty-eighth,thirty-fifth,thirty-first,thirty-fourth,thirty-ninth,thirty-second,thirty-seventh,thirty-sixth,thirty-third,thousandth,trillionth,twelfth,twentieth,twenty-eighth,twenty-fifth,twenty-first,twenty-fourth,twenty-ninth,twenty-second,twenty-seventh,twenty-sixth,twenty-third,umpteenth,zero,zeroth
single.a.03	lone,lonesome,one-man,one-person,one-woman,only,single,singular,sole,solitary,unary,unique	aggregate,binary,double,doubled,dual,duple,duplex,eightfold,five-fold,fivefold,four-fold,fourfold,manifold,multiple,multiplex,ninefold,quadruple,quadruplex,quaternary,quintuple,septuple,sevenfold,sextuple,six-fold,sixfold,ten-fold,tenfold,ternary,three-fold,threefold,treble,triple,triplex,triune,two-fold,twofold
skilled.a.01	accomplished,adept,arch,complete,consummate,delicate,expert,good,hot,masterful,masterly,mean,practiced,proficient,skilful,skilled,skillful,technical,versatile,virtuoso	artless,botched,bungled,bungling,clumsy,crude,fumbling,hopeless,humble,incompetent,lowly,menial,rough,rusty,semiskilled,unskilled,unskillful,weak
coarse.a.01	coarse,coarse-grained,grainy,granular,granulated,gritty,harsh,loose,mealy,open	close,fine,fine-grained,floury,powdered,powdery,pulverised,pulverized,small,superfine,tight
smooth.a.01	aerodynamic,fast,flowing,glassy,seamless,sleek,smooth,streamlined,unlined,velvet,velvety	abrasive,broken,bumpy,chapped,corded,cracked,craggy,crushed,gravelly,hilly,homespun,imbricate,lined,mountainous,nubby,pebbly,pocked,pockmarked,potholed,ribbed,rocky,rough,roughened,rugged,rugose,scabby,scabrous,scaly,scratchy,seamed,shagged,shaggy,stony,textured,tweedy,warty
smooth.a.03	entire,sinuate,smooth,undulate	bidentate,ciliate,ciliated,crenate,crenulated,dentate,denticulate,emarginate,fringed,jagged,lacerate,lacerated,notched,rough,scalloped,serrate,serrated,spinose,toothed
social.a.02	cultural,ethnic,ethnical,gregarious,interpersonal,multi-ethnic,multiethnic,social	alone,antisocial,asocial,lone,lonely,recluse,reclusive,solitary,unsocial,withdrawn
solid.a.02	coagulated,concrete,congealed,dry,jelled,jellied,semisolid,solid,solid-state,solidified	aerosolized,evaporated,fluid,gaseous,gasified,gassy,liquefied,liquid,liquified,runny,vaporized,vaporous,watery
liquid.a.01	fluid,liquefied,liquid,liquified,runny,watery	aerosolized,coagulated,concrete,congealed,dry,evaporated,gaseous,gasified,gassy,jelled,jellied,semisolid,solid,solid-state,solidified,vaporized,vaporous
gaseous.a.01	aerosolized,evaporated,gaseous,gasified,gassy,vaporized,vaporous	coagulated,concrete,congealed,dry,fluid,jelled,jellied,liquefied,liquid,liquified,runny,semisolid,solid,solid-state,solidified,watery
soluble.a.01	dissolvable,fat-soluble,soluble,water-soluble	indissoluble,insoluble,water-insoluble
soluble.a.02	answerable,resolvable,soluble,solvable	insoluble,unresolvable,unsolvable
some.a.01	any,both,several,some,whatever,whatsoever	all,each,every,nary,no,none,zero
no.a.01	nary,no,none,zero	all,any,both,each,every,several,some,whatever,whatsoever
all.a.01	all,each,every	any,both,nary,no,none,several,some,whatever,whatsoever,zero
sophisticated.a.01	blase,intelligent,polished,refined,sophisticated,svelte,urbane,well-informed,worldly	childlike,credulous,green,gullible,ingenuous,innocent,naif,naive,simple,simple-minded,unsophisticated,unworldly,wide-eyed
sound.a.01	dependable,good,healthy,safe,secure,solid,sound,stable	bad,high-risk,long,risky,speculative,unsound,wildcat
sound.a.03	solid,sound,strong,substantial	corroded,decayed,rotted,rotten,unsound
specialized.a.01	differentiated,special,specialised,specialized	generalised,generalized,unspecialized
spirited.a.01	barmy,boisterous,dashing,ebullient,exuberant,feisty,gallant,high-spirited,impertinent,irreverent,knockabout,lively,pert,plucky,racy,resilient,saucy,snappy,spirited,sprightly,spunky,vibrant,vivacious,whipping,yeasty,zestful,zesty	apathetic,bloodless,dispirited,heartless,listless,spiritless,thin
spontaneous.a.01	impulsive,instinctive,intuitive,natural,self-generated,spontaneous,unprompted	elicited,evoked,iatrogenic,induced
spoken.a.01	expressed,oral,spoken,unwritten,uttered,verbal,verbalized,word-of-mouth	backhand,cursive,engrossed,graphic,graphical,handwritten,holographic,inscribed,longhand,shorthand,written
stable.a.01	firm,lasting,stabile,stabilised,stabilized,stable,steady	crank,cranky,explosive,rickety,rocky,seismic,shaky,tender,tippy,tipsy,top-heavy,tottering,unstable,volatile,volcanic,wobbly,wonky
standard.a.01	modular,regular,regulation,standard,standardised,standardized,stock	deficient,inferior,nonstandard,substandard
standard.a.04	acceptable,classical,received,standard	bad,nonstandard,unacceptable,unaccepted
nourished.a.01	full,nourished,overfed,replete,well-fed	malnourished,starved,starving,underfed,undernourished,unfed
steady.a.01	dependable,even,firm,level,regular,steadied,steady,sure,sure-footed,surefooted,unwavering	arrhythmic,convulsive,faltering,flickering,fluctuating,jerking,jerky,palpitating,quavering,shaky,shifting,shifty,shivering,shuddering,spasmodic,spastic,tottering,trembling,tremulous,uneven,unsteady,wobbling
stimulating.a.01	challenging,exciting,piquant,rousing,salty,stimulating,stirring,thought-provoking,thrilling	bland,dry,flat,unexciting,vapid
depressant.a.01	depressant,hypnagogic,narcotic,relaxant,sedative,soporific,tranquilizing	adrenocorticotropic,excitatory,irritating,stimulant,stimulating,stimulative
straight.a.02	aligned,straight,untwisted	akimbo,aquiline,askew,awry,cockeyed,contorted,crooked,geniculate,gnarled,gnarly,hooked,knobbed,knotted,knotty,lopsided,reflexed,refractive,squiggly,tortuous,twisting,twisty,voluminous,warped,windblown,winding,wonky,writhed,wry,zig-zag,zigzag
straight.a.06	aboveboard,guileless,square,straight,straightforward,transparent	corrupt,crooked,sneaky,underhand,underhanded
stressed.a.02	accented,emphasised,emphasized,emphatic,masculine,stressed	feminine,light,unaccented,unstressed,weak
strong.a.01	brawny,fortified,hard,hefty,knock-down,knockout,muscular,noticeable,powerful,reinforced,robust,severe,sinewy,stiff,strengthened,strong,vehement,virile,weapons-grade	anaemic,anemic,debilitated,enervated,faint,feeble,flimsy,gutless,lame,pale,pallid,puny,shoddy,sick,spineless,vulnerable,wan,weak,weakened
stubborn.a.01	bullheaded,cantankerous,determined,dogged,dour,hardheaded,obstinate,persistent,pigheaded,strong-minded,strong-willed,stroppy,stubborn,tenacious,unregenerate,unyielding	docile,meek,sheepish,tame,yielding
subordinate.a.02	dependent,feudatory,ruled,subject,subordinate,subservient	disobedient,insubordinate,mutinous,rebellious,unruly
successful.a.01	boffo,booming,flourishing,in,made,no-hit,palmy,productive,prospering,prosperous,roaring,self-made,successful,sure-fire,thriving,victorious,winning	attempted,defeated,disappointed,discomfited,down-and-out,empty-handed,foiled,frustrated,goalless,hitless,no-win,out,ruined,scoreless,self-defeating,sunk,thwarted,undone,unfulfilled,unplaced,unrealised,unrealized,unrewarded,unsuccessful,washed-up,winless
sufficient.a.01	adequate,comfortable,decent,enough,sufficient	deficient,depleted,inadequate,insufficient,lean,light,low,poor,scant,short,shy,skimpy
superior.a.02	arch,condescending,eminent,high,high-level,high-ranking,leading,majestic,olympian,patronising,patronizing,preeminent,superior,superordinate,upper,upper-level	humble,indifferent,inferior,low,low-level,lowly,middle-level,modest,outclassed,small
superior.a.01	ace,banner,blue-ribbon,boss,brag,brilliant,capital,choice,crack,excellent,first-class,first-rate,greatest,high-performance,outstanding,premium,prime,prize,pukka,quality,select,shining,spiffing,splendid,sterling,super,superb,superior,superlative,supreme,surpassing,tiptop,top-flight,top-notch,topnotch,topping,tops,transcendent,weapons-grade,well-made	bad,base,bum,bush,cheap,cheesy,chintzy,coarse,coarsened,commercial,commercial-grade,common,crummy,deplorable,execrable,inferior,less,low-grade,mediocre,miserable,punk,ropy,scrawny,scrubby,second-class,second-rate,shoddy,sleazy,stunted,tawdry,third-rate,tinny,utility,woeful,wretched
supported.a.01	subsidised,subsidized,supported	baseless,groundless,idle,single-handed,unassisted,uncorroborated,unfounded,unsubstantiated,unsupported,unwarranted,wild
assisted.a.01	aided,assisted,power-assisted	naked,unaided,unassisted
supportive.a.01	accessory,adjunct,adjuvant,ancillary,appurtenant,auxiliary,collateral,confirmatory,confirming,corroborative,encouraging,substantiating,supporting,supportive,validating,verifying	confounding,contradictory,invalidating,unsupportive
susceptible.a.01	allergic,amenable,capable,hypersensitive,liable,nonresistant,open,persuadable,pliable,predisposed,sensitised,sensitized,subject,suggestible,supersensitive,susceptible,tractable,unvaccinated,vulnerable	immune,immunised,immunized,immunogenic,incapable,resistant,unresponsive,vaccinated
exempt.a.01	excused,exempt,immune,privileged	liable,nonexempt,taxpaying,unexcused
sweet.a.01	cloying,saccharine,sweet,sweetish,syrupy,treacly	acerbic,acid,acidic,astringent,lemony,sour,tangy,tart,vinegary
soured.a.01	off,sour,soured,turned	fresh,sweet,unfermented
symmetrical.a.01	bilateral,centrosymmetric,cruciate,cruciform,even,interchangeable,isosceles,radial,radiate,regular,rhombohedral,stellate,symmetric,symmetrical,trigonal	asymmetric,asymmetrical,lopsided,unsymmetrical
sympathetic.a.04	appealing,likable,likeable,sympathetic	unappealing,unlikable,unlikeable,unsympathetic
synchronous.a.01	coeval,coexisting,coincident,coincidental,coinciding,concurrent,contemporaneous,contemporary,parallel,simultaneous,synchronic,synchronised,synchronized,synchronous	anachronistic,asynchronous,serial,unsynchronized
tall.a.01	gangling,gangly,lanky,leggy,long,long-legged,rangy,stately,statuesque,tall	chunky,compact,dumpy,half-length,heavyset,little,low-set,pint-sized,runty,sawed-off,short,squab,squat,squatty,stocky,stumpy,thick,thickset
tame.a.03	broken,cultivated,docile,domestic,domesticated,gentle,tame,tamed	feral,savage,semi-wild,unbroken,undomesticated,untamed,wild
tasteful.a.01	aesthetic,artistic,esthetic,tasteful,understated,unostentatious,unpretentious	barbaric,brassy,camp,campy,cheap,flash,flashy,garish,gaudy,gimcrack,indelicate,loud,meretricious,off-color,ostentatious,pretentious,tacky,tasteless,tatty,tawdry,trashy
tasty.a.01	acrid,ambrosial,ambrosian,bitter,bittersweet,choice,dainty,delectable,delicious,flavorful,fruity,full-bodied,gingery,hot,luscious,nippy,nutty,peppery,piquant,pungent,racy,rich,robust,salty,savory,savoury,scrumptious,semisweet,smoky,sour,spicy,tasty,toothsome,winey,winy,yummy,zesty	bland,flat,flavorless,insipid,tasteless,unflavored,unsalted,unseasoned,vapid
taxable.a.01	assessable,dutiable,nonexempt,rateable,taxable	duty-free,exempt,nontaxable,tax-exempt,tax-free,untaxed
temperate.a.02	abstemious,light,moderate,restrained,temperate	big,heavy,intemperate
tense.a.03	taut,tense,tight	drooping,droopy,floppy,lax,limp,loose,sagging,slack
tense.a.01	antsy,aroused,edgy,electric,fidgety,fretful,high-strung,isotonic,itchy,jittery,jumpy,nail-biting,nervous,nervy,pumped,restive,strained,suspenseful,suspensive,taut,tense,uptight,wired	laid-back,mellow,relaxed,unstrained
thick.a.01	deep,fat,heavy,quilted,thick,thickened	bladed,capillary,cobwebby,compressed,depressed,diaphanous,filamentous,filiform,filmy,fine,flat,gauzy,gossamer,hairlike,hyperfine,light,papery,see-through,sheer,sleazy,slender,tenuous,thin,threadlike,thready,transparent,vaporous
thick.a.03	clogged,clotted,coagulate,coagulated,creamy,curdled,dense,gelatinous,heavy,impenetrable,jellylike,ropy,soupy,stringy,syrupy,thick,thickened,thready,viscous	rare,rarefied,rarified,tenuous,thin
thinkable.a.01	conceivable,imaginable,presumable,thinkable	impossible,inconceivable,unimaginable,unthinkable
thoughtful.a.02	bemused,brooding,broody,contemplative,deliberative,lost,meditative,musing,pensive,pondering,preoccupied,reflective,ruminative,thoughtful	inconsiderate,thoughtless,unconsidered,unreflective,unthinking
thrifty.a.01	economical,frugal,saving,scotch,sparing,stinting,thrifty	extravagant,prodigal,profligate,spendthrift,uneconomic,uneconomical,wasteful
tidy.a.01	clean-cut,neat,orderly,shipshape,straight,tidy,trig,trim,uncluttered,well-kept	blowsy,blowzy,cluttered,disheveled,dishevelled,disorderly,jumbled,littered,messy,rambling,rumpled,scraggly,slatternly,sloppy,slouchy,slovenly,sprawling,straggling,straggly,topsy-turvy,tousled,unkempt,untidy
groomed.a.01	brushed,groomed,kempt,plastered,sleek,slicked,tidy,well-dressed,well-groomed	bushy,shaggy,ungroomed
tired.a.01	beat,bleary,bored,burned-out,burnt-out,bushed,careworn,dead,drained,drawn,drooping,exhausted,fatigued,flagging,footsore,haggard,jaded,knackered,ragged,spent,tired,washed-out,wearied,weary,whacked,world-weary,worn,worn-out	fresh,invigorated,refreshed,reinvigorated,rested
tolerable.a.01	bearable,endurable,resistant,supportable,tolerable,tolerant	bitter,impossible,insufferable,intolerable,unacceptable,unbearable,unendurable,unsupportable
top.a.01	apical,crowning,top,topmost,upmost,upper,uppermost	bottom,broadside,inferior,lateral,lowermost,nether,side,sidelong
bottom.a.01	bottom,inferior,lowermost,nether	apical,broadside,crowning,lateral,side,sidelong,top,topmost,upmost,upper,uppermost
side.a.01	broadside,lateral,side,sidelong	apical,bottom,crowning,inferior,lowermost,nether,top,topmost,upmost,upper,uppermost
tough.a.07	cartilaginous,chewy,coriaceous,fibrous,gristly,hempen,leathered,leathery,rubbery,sinewy,stringy,tough	chewable,crisp,crispy,flakey,flaky,tender,tenderized
tough.a.03	callous,calloused,hardened,inured,thickened,tough,toughened	delicate,soft,tender
tough.a.01	hard-bitten,hard-boiled,pugnacious,tough,tough-minded,unsentimental	protective,sentimental,tender
toxic.a.01	cyanogenic,deadly,hepatotoxic,poisonous,toxic,toxicant,venomous,virulent	nonpoisonous,nontoxic,nonvenomous
tractable.a.01	docile,ductile,malleable,manipulable,teachable,tractable	balking,balky,intractable,refractory,stubborn,uncontrollable,unmanageable
trimmed.a.01	clipped,cut,trimmed	unclipped,uncut,untrimmed
troubled.a.01	annoyed,anxious,buffeted,careful,clouded,disquieted,distressed,disturbed,fraught,harassed,hard-pressed,harried,haunted,nervous,pestered,queasy,stressed,struggling,suffering,tormented,troubled,uneasy,unquiet,upset,vexed,worried	carefree,clear,dreamless,trouble-free,unconcerned,undisturbed,unmolested,untroubled,unworried
true.a.01	actual,genuine,literal,real,sure,true,truthful	false,mendacious,specious,spurious,trumped-up,untrue
trustful.a.01	confiding,trustful,trusting,unsuspecting	cynical,distrustful,doubting,green-eyed,jealous,leery,misanthropic,mistrustful,questioning,sceptical,skeptical,suspicious,untrusting,wary
trustworthy.a.01	authentic,creditworthy,dependable,fiducial,honest,reliable,responsible,sure,true,trusted,trustworthy,trusty	devious,shady,shifty,slippery,tricky,untrustworthy
typical.a.01	emblematic,exemplary,regular,representative,true,typical,veritable	atypical,unrepresentative,untypical
underhand.a.01	underarm,underhand,underhanded	overarm,overhand,round-arm
surface.a.01	aboveground,opencast,surface	overhead,submarine,submerged,submersed,subsurface,subterranean,underground,undersea,underwater
subsurface.a.01	submarine,submerged,submersed,subsurface,subterranean,underground,undersea,underwater	aboveground,opencast,overhead,surface
union.a.02	closed,organised,organized,union,unionised,unionized	nonunion,nonunionized,open,unorganised,unorganized
united.a.01	agreed,allied,amalgamate,amalgamated,coalesced,coalescent,coalescing,cohesive,confederate,conjugate,conjugated,conjunct,consolidated,coupled,federate,federated,fused,incorporate,incorporated,integrated,merged,one,suprasegmental,tied,undivided,unified,unitary,united,unsegmented	bicameral,bifid,bifurcate,bifurcated,black-and-white,branched,chambered,cloven,dichotomous,disconnected,disjointed,disjunct,disunited,divided,episodic,forked,fragmented,mullioned,pronged,sectional,sectioned,segmental,segmented,split,three-pronged,torn,trifid,two-pronged
ascending.a.01	ascendant,ascendent,ascending,highflying,rising,up,uphill,upward	descendant,descendent,descending,down,downhill,downward,drizzling,dropping,falling,raining
rising.a.01	improving,rising,up	down,falling,soft
up.a.01	ahead,aweigh,heavenward,leading,risen,skyward,sprouted,up,upfield,upward	behind,down,downcast,downfield,downward,fallen,set,thrown,weak
used.a.01	used,utilised,utilized	abused,exploited,misused,put-upon,used,victimised,victimized
useful.a.01	multipurpose,recyclable,reusable,serviceable,usable,useable,useful,utile,utilitarian	futile,ineffectual,unavailing,unserviceable,unusable,useless
valid.a.01	binding,effectual,legal,legitimate,logical,reasoned,sound,valid,validated,well-grounded	bad,fallacious,false,invalid,invalidated,null,nullified,sophistic,sophistical,uncollectible,unsound,void
valuable.a.01	blue-chip,invaluable,precious,priceless,rich,semiprecious,valuable,worth	good-for-nothing,meritless,negligible,no-good,nugatory,paltry,pointless,purposeless,senseless,sorry,superfluous,tinpot,trashy,trifling,valueless,wasted,worthless
variable.a.01	changeable,covariant,multivariate,protean,shifting,uncertain,unsettled,variable,variant,versatile	changeless,constant,invariable,invariant,strict,unvarying
ventilated.a.01	aired,airy,louvered,vented,ventilated	airless,close,stuffy,unaired,unventilated
violent.a.01	convulsive,ferocious,fierce,furious,hot,lashing,lurid,raging,savage,tough,violent	nonviolent,passive,peaceful
virtuous.a.01	impeccable,innocent,sinless,virtuous	evil,heavy,heinous,iniquitous,irredeemable,nefarious,sinful,ungodly,unredeemable,vicious,villainous,wicked
visible.a.01	circumpolar,gross,macroscopic,microscopic,microscopical,ocular,telescopic,viewable,visible,visual	camouflaged,concealed,hidden,infrared,invisible,lightless,occult,ultraviolet,undetectable
voluntary.a.01	freewill,self-imposed,uncoerced,unforced,unpaid,voluntary,volunteer,wilful,willful,willing	driven,forced,goaded,involuntary,unconscious,unwilling
vulnerable.a.01	compromising,defenceless,defenseless,endangered,indefensible,insecure,open,penetrable,threatened,undefended,unguarded,unsafe,vulnerable	air-tight,airtight,bombproof,defendable,defensible,entrenched,impregnable,inviolable,invulnerable,secure,sheltered,strong,tight,unassailable,untouchable
wanted.a.01	craved,desired,hot,sought,sought-after,wanted	cast-off,discarded,friendless,outcast,outcaste,throwaway,unclaimed,undesired,unsought,unwanted,unwelcome
warm.a.01	lukewarm,tepid,warm,warmed,warming	air-conditioned,air-cooled,caller,cool,water-cooled
increasing.a.01	accretionary,accretive,augmentative,increasing,maximising,maximizing,multiplicative,progressive,raising	decreasing,depreciating,diminishing,dwindling,falling,tapering
well.a.01	asymptomatic,cured,healed,recovered,symptomless,well	afflicted,ailing,airsick,autistic,bedridden,bilious,carsick,consumptive,convalescent,delirious,diabetic,dizzy,dyspeptic,faint,feverish,funny,giddy,gouty,green,hallucinating,ill,indisposed,light,lightheaded,livery,nauseated,nauseous,palsied,paralytic,paralyzed,paraplegic,peaked,poorly,queasy,recovering,rickety,seasick,seedy,sick,sickly,sneezy,spastic,stricken,swooning,tubercular,tuberculous,unhealed,unwell,upset,vertiginous,woozy
wet.a.01	boggy,clammy,damp,dank,dewy,drippy,drizzly,humid,marshy,misty,moist,mucky,muddy,muggy,rainy,reeking,rheumy,showery,sloppy,sodden,soggy,soppy,steaming,steamy,sticky,swampy,tacky,washed,waterlogged,watery,wet	air-dried,arid,baked,desiccated,dried,dried-up,dry,parched,rainless,scorched,sear,semi-dry,semiarid,sere,shriveled,shrivelled,sunbaked,thirsty,waterless,withered
white-collar.a.01	clerical,professional,white-collar	blue-collar,industrial,manual,working-class
wholesome.a.01	alimentary,healthy,hearty,nourishing,nutrient,nutritious,nutritive,organic,salubrious,satisfying,solid,square,substantial,wholesome	insalubrious,insubstantial,jejune,loathsome,morbid,nauseating,nauseous,noisome,offensive,queasy,rich,sickening,unhealthful,unhealthy,unwholesome,vile
wide.a.01	broad,broad-brimmed,deep,panoramic,sweeping,wide,wide-screen	constricting,constrictive,narrow,narrowed,narrowing,slender,strait,tapered,tapering,thin
willing.a.01	consenting,disposed,fain,glad,happy,inclined,prepared,ready,volitional,willing	grudging,loath,loth,reluctant,unintentional,unwilling
wise.a.01	all-knowing,omniscient,owlish,perspicacious,sagacious,sage,sapient,wise	absurd,asinine,cockamamie,cockeyed,derisory,fatuous,fond,foolish,goofy,harebrained,idiotic,ill-conceived,inane,insane,laughable,ludicrous,mad,mindless,misguided,nonsensical,preposterous,ridiculous,sappy,scatterbrained,silly,unwise,vacuous,wacky,whacky,zany
worldly.a.01	economic,material,materialistic,mercenary,mundane,secular,temporal,terrestrial,worldly	cloistered,conventual,eremitic,monastic,spiritual,unearthly,unworldly
worthy.a.01	commendable,creditable,deserving,exemplary,laudable,meritorious,model,notable,noteworthy,praiseworthy,precious,quotable,sacred,valuable,valued,worth,worthwhile,worthy	undeserving,unmerited,unworthy
